地球上的星星	地球上的星星
两生花	两生花
分手吧是我让你累了	分手吧是我让你累了
故乡的雨	故乡的雨
夏日里的春天	夏日里的春天
你爱我吗	你爱我吗
如此婚姻	如此婚姻
博士的爱情方程式	博士的爱情方程式
阶伯	阶伯
春江英雄之秀才遇到兵	春江英雄之秀才遇到兵
风声	风声
食色男女	食色男女
苏染染追夫记	苏染染追夫记
如果·爱	如果·爱
我也会爱上别人的	我也会爱上别人的
星际旅行	星际旅行
郑中基	郑中基
汉城大劫案	汉城大劫案
情满珠江	情满珠江
祝你一路顺风	祝你一路顺风
樱花庄的宠物女孩	樱花庄的宠物女孩
烈火狂奔	烈火狂奔
祝你愉快	祝你愉快
DOOM DADA	DOOM DADA
若是你能遇见她	若是你能遇见她
阿尼斯	阿尼斯
黑色星期五	黑色星期五
郑天寿	郑天寿
爱情海	爱情海
落金扇	落金扇
兄弟姐妹	兄弟姐妹
新楚留香	新楚留香
少林三十六房	少林三十六房
雳剑	雳剑
民兵葛二蛋	民兵葛二蛋
四月碎片	四月碎片
天神剑女	天神剑女
爱无悔	爱无悔
天亮·分手	天亮·分手
破天荒	破天荒
简·爱	简·爱
因为爱你	因为爱你
西班牙斗牛	西班牙斗牛
Elephant Dee	Elephant Dee
starships	starships
影舞者	影舞者
没有忘掉他	没有忘掉他
你知道我在等你吗	你知道我在等你吗
男人信什么	男人信什么
花吃了这女孩	花吃了这女孩
死亡幻觉	死亡幻觉
高坂桐乃	高坂桐乃
五号特工组2	五号特工组2
阳光天使	阳光天使
精神病医师赫夫	精神病医师赫夫
中国兄弟连	中国兄弟连
今生无悔	今生无悔
明日已太远	明日已太远
丁家有女喜洋洋	丁家有女喜洋洋
别害怕	别害怕
我的如意狼君	我的如意狼君
蒙古王	蒙古王
幸福还有多远	幸福还有多远
秋天的童话	秋天的童话
初恋的故事	初恋的故事
不信地狱	不信地狱
我没有疯	我没有疯
铁血尖刀	铁血尖刀
菊豆	菊豆
珍珠传奇	珍珠传奇
牡丹亭	牡丹亭
美美	美美
金刚葫芦侠	金刚葫芦侠
爱情雨	爱情雨
小夫妻大战白血病	小夫妻大战白血病
童话	童话
孙子兵法与三十六计	孙子兵法与三十六计
新娘三颗星	新娘三颗星
无心法师	无心法师
命运的承诺	命运的承诺
灭绝师太	灭绝师太
泪光闪闪	泪光闪闪
孤芳不自赏	孤芳不自赏
线人	线人
极道鲜师电影版	极道鲜师电影版
弃妇	弃妇
我所谓的生活	我所谓的生活
帝王的女儿守百香	帝王的女儿守百香
第39号案件	第39号案件
北之零年	北之零年
池袋西口公园	池袋西口公园
河畔的朔子	河畔的朔子
爱一个人好难	爱一个人好难
五十度黑	五十度黑
废柴兄弟	废柴兄弟
百日告别	百日告别
巴山恋曲	巴山恋曲
Back Home	Back Home
克格勃无间事件	克格勃无间事件
三枪拍案惊奇	三枪拍案惊奇
速度与激情	速度与激情
Flashback	Flashback
大地之女	大地之女
银实	银实
巨人	巨人
喜欢你	喜欢你
One Step	One Step
特警新人类	特警新人类
血玲珑	血玲珑
一触即发	一触即发
沉	沉
茅山僵尸拳	茅山僵尸拳
真命天师	真命天师
王与妃	王与妃
英雄广东十虎	英雄广东十虎
守护爱情	守护爱情
星光灿烂	星光灿烂
You Are Not Alone	You Are Not Alone
詹妮弗的肉体	詹妮弗的肉体
星际迷航	星际迷航
摘星	摘星
加州阳光	加州阳光
怒放的生命	怒放的生命
小叮当	小叮当
野孩子	野孩子
无间道3：终极无间	无间道3：终极无间
抬花轿	抬花轿
非常嫌疑犯	非常嫌疑犯
妖精别走	妖精别走
浮沉的兄弟	浮沉的兄弟
恶之花	恶之花
梦想天堂	梦想天堂
另类爱情	另类爱情
狼毒花	狼毒花
轩辕剑之汉之云	轩辕剑之汉之云
八七87	八七87
樱花印记	樱花印记
思觉失调	思觉失调
夜夜	夜夜
彩虹天堂	彩虹天堂
pasta	pasta
亲爱的别让我受伤	亲爱的别让我受伤
羊城奇遇记	羊城奇遇记
曾经的爱	曾经的爱
昆仑ol	昆仑ol
精舞门2	精舞门2
97变色龙	97变色龙
谜中迷	谜中迷
重庆谈判	重庆谈判
数码精品世界	数码精品世界
燃烧翅膀	燃烧翅膀
检察官外传	检察官外传
西部往事	西部往事
不要回头	不要回头
消失的子弹	消失的子弹
年轻气盛	年轻气盛
完美结局	完美结局
我的梦想我做主	我的梦想我做主
我会好好的	我会好好的
天才在左疯子在右	天才在左疯子在右
爱情	爱情
公爵夫人	公爵夫人
唐朝浪漫英雄	唐朝浪漫英雄
社区民警故事	社区民警故事
逐梦令	逐梦令
轰轰战队冒险者	轰轰战队冒险者
嫁给你啦	嫁给你啦
杨八姐游春	杨八姐游春
扰民了你	扰民了你
少年刑警	少年刑警
我的父亲是板凳	我的父亲是板凳
不再让你孤单	不再让你孤单
四个婚礼和一个葬礼	四个婚礼和一个葬礼
凤凰花开的路口	凤凰花开的路口
少年阿虎	少年阿虎
为你写诗	为你写诗
银海惊涛	银海惊涛
公益中国爱心满世界	公益中国爱心满世界
Can'T Stop	Can'T Stop
吸血姬美夕	吸血姬美夕
情非得已之生存之道	情非得已之生存之道
安天会	安天会
爱在廊桥	爱在廊桥
Touch	Touch
旺角卡门	旺角卡门
第二十二条军规	第二十二条军规
月亮代表我的心	月亮代表我的心
金玉奴	金玉奴
小鱼儿与花无缺	小鱼儿与花无缺
爱恨情仇	爱恨情仇
凰权·弈天下	凰权·弈天下
爱，在离别时	爱，在离别时
快乐不再快乐	快乐不再快乐
想念你	想念你
封神	封神
法证先锋Ⅲ	法证先锋Ⅲ
唱·战记	唱·战记
少林寺传奇之大漠英豪	少林寺传奇之大漠英豪
法证先锋Ⅱ	法证先锋Ⅱ
游子吟	游子吟
TARI TARI	TARI TARI
只是爱着你	只是爱着你
幸福秘方	幸福秘方
布衣孔子	布衣孔子
绑架冰激凌	绑架冰激凌
奇妙蝴蝶	奇妙蝴蝶
九更天	九更天
匹诺曹	匹诺曹
虫之诗	虫之诗
巴巴罗萨·海雷丁	巴巴罗萨·海雷丁
爱的奉献	爱的奉献
狐影	狐影
小品	小品
欲望号街车	欲望号街车
大明劫	大明劫
宗家餐厅	宗家餐厅
敌后武工队	敌后武工队
暗战	暗战
水返脚的春天	水返脚的春天
顺风妇产科	顺风妇产科
睡人	睡人
对对子	对对子
深夜咖啡馆之失踪少女	深夜咖啡馆之失踪少女
速成沼泽	速成沼泽
下南洋	下南洋
摔角王	摔角王
喜爱夜蒲	喜爱夜蒲
别走	别走
封面女郎	封面女郎
最后是我开了口	最后是我开了口
江湖奇案	江湖奇案
纵横四海	纵横四海
月琴弹起来	月琴弹起来
旗木卡卡西	旗木卡卡西
快乐到死	快乐到死
摩洛哥	摩洛哥
双海真美	双海真美
圣水湖畔	圣水湖畔
深深深	深深深
女子戏班	女子戏班
配音	配音
富士山下	富士山下
夏洛特烦恼	夏洛特烦恼
再见溪谷	再见溪谷
天上的西藏	天上的西藏
东京公园	东京公园
媒体	媒体
新玉观音	新玉观音
狗仔队	狗仔队
喷嚏大魔怪	喷嚏大魔怪
失控·幽灵飞车	失控·幽灵飞车
我爱桃花	我爱桃花
真爱诺言	真爱诺言
萤之光	萤之光
不要相信她	不要相信她
龙与虎	龙与虎
魂流彼岸	魂流彼岸
产前阵痛	产前阵痛
角斗士	角斗士
望海的女人	望海的女人
北京2008	北京2008
I Love You Always Forever	I Love You Always Forever
我和僵尸有个约会2	我和僵尸有个约会2
我和僵尸有个约会3	我和僵尸有个约会3
功勋	功勋
岁月风云	岁月风云
垒球少年	垒球少年
软硬制造	软硬制造
风云小棋王	风云小棋王
翡翠恋曲	翡翠恋曲
阳光地带	阳光地带
夏目贵志	夏目贵志
小上坟	小上坟
木兰花	木兰花
M·凯撒·库朗	M·凯撒·库朗
兵团岁月	兵团岁月
菜鸟囧探	菜鸟囧探
人再囧途之泰囧	人再囧途之泰囧
黎明前的暗战	黎明前的暗战
错爱2	错爱2
LEGAL HIGH	LEGAL HIGH
墨攻	墨攻
不是猛龙不过江	不是猛龙不过江
秀才与刽子手	秀才与刽子手
我等你	我等你
爱在女儿乡	爱在女儿乡
大工匠	大工匠
太利	太利
恋爱SOS	恋爱SOS
诡眼	诡眼
我们毕业啦	我们毕业啦
绿色马车	绿色马车
盲侠血滴子	盲侠血滴子
顽皮炸弹	顽皮炸弹
超霸花神	超霸花神
弱点	弱点
美丽的笨女人	美丽的笨女人
你还好吗	你还好吗
大唐诗圣	大唐诗圣
极光之恋	极光之恋
GO!大暴走	GO!大暴走
狙击速递	狙击速递
爱是这辈子的坟	爱是这辈子的坟
山楂树之恋	山楂树之恋
寻你到天涯	寻你到天涯
可可的魔伞	可可的魔伞
小心我外婆	小心我外婆
加速度	加速度
艋舺	艋舺
在一起	在一起
绝口不提爱你	绝口不提爱你
考拉小子：英雄的诞生	考拉小子：英雄的诞生
原声之旅	原声之旅
金田一少年之事件簿N	金田一少年之事件簿N
死亡飞车	死亡飞车
恩怨两姐妹	恩怨两姐妹
孽缘	孽缘
国家	国家
秘岸	秘岸
功夫	功夫
那么爱你为什么	那么爱你为什么
Laughing Tonight	Laughing Tonight
listen	listen
爱我	爱我
打擂台	打擂台
大连故事	大连故事
姊妹花	姊妹花
牵手人生	牵手人生
聊斋艳谭	聊斋艳谭
施公奇案	施公奇案
蓝色较量	蓝色较量
谢谢你的美好	谢谢你的美好
牵手	牵手
死亡派对	死亡派对
心要让你听见	心要让你听见
金田一少年之事件簿3	金田一少年之事件簿3
情迷大话王	情迷大话王
Space Oddity	Space Oddity
精变	精变
雀圣	雀圣
直到世界终结	直到世界终结
戴潆萱	戴潆萱
大唐文宗	大唐文宗
致命罗密欧	致命罗密欧
幸福一定强	幸福一定强
我爱你很多	我爱你很多
情越海岸线	情越海岸线
还是朋友	还是朋友
梦想中国	梦想中国
卡莲·休妲菲尔特	卡莲·休妲菲尔特
两部曲	两部曲
忠勇小状元	忠勇小状元
服部平次	服部平次
爆裂刑警	爆裂刑警
好心好报	好心好报
快乐星球	快乐星球
哭砂	哭砂
最佳男朋友	最佳男朋友
Angela	Angela
乌云背后的幸福线	乌云背后的幸福线
秋：故事	秋：故事
我的骄傲	我的骄傲
刑警	刑警
台湾水浒传	台湾水浒传
桃花庵	桃花庵
天地豪情	天地豪情
爱你别走	爱你别走
大智若愚	大智若愚
Bling Star	Bling Star
幸福最晴天	幸福最晴天
西厢记	西厢记
锉冰进行曲	锉冰进行曲
敲敲爱上你	敲敲爱上你
奋斗	奋斗
谢文东4：风云再起之再战江湖	谢文东4：风云再起之再战江湖
翻新大少	翻新大少
相田爱	相田爱
青春常驻	青春常驻
捕蛇行动	捕蛇行动
机灵小不懂	机灵小不懂
穆桂英挂帅	穆桂英挂帅
光荣人家	光荣人家
毛泽东与齐白石	毛泽东与齐白石
粉与灰	粉与灰
军师官兵卫	军师官兵卫
女人之路	女人之路
月光下我记得	月光下我记得
纽伦堡大审判	纽伦堡大审判
田埂上的梦2	田埂上的梦2
拐个皇帝回现代	拐个皇帝回现代
福贵	福贵
小芳	小芳
小花	小花
红舞鞋	红舞鞋
夜宴	夜宴
美的诱惑	美的诱惑
一个无政府主义者的意外死亡	一个无政府主义者的意外死亡
蒸发密令	蒸发密令
少年汉尼拔	少年汉尼拔
三更冤	三更冤
宇宙锋	宇宙锋
和莎莫的500天	和莎莫的500天
我的雷人男友	我的雷人男友
清潭洞爱丽丝	清潭洞爱丽丝
突然想爱你	突然想爱你
厨子·戏子·痞子	厨子·戏子·痞子
封神榜之凤鸣岐山	封神榜之凤鸣岐山
把悲伤留给自己	把悲伤留给自己
第九个寡妇	第九个寡妇
满天繁星	满天繁星
侠客行	侠客行
情锁	情锁
上海滩	上海滩
开始懂了	开始懂了
涛声依旧	涛声依旧
SORRY	SORRY
最游记	最游记
我的特一营	我的特一营
献世	献世
最佳现场	最佳现场
费玉清	费玉清
通天塔	通天塔
妈妈的吻	妈妈的吻
陆文龙	陆文龙
最强的名医	最强的名医
快递甜心	快递甜心
千里走单骑	千里走单骑
续·倒数第二次恋爱	续·倒数第二次恋爱
在那遥远的小山村	在那遥远的小山村
天下	天下
护花危情	护花危情
咱爸咱妈六十年	咱爸咱妈六十年
valenti	valenti
无敌幸运星	无敌幸运星
绝对空虚	绝对空虚
一个人	一个人
爸爸的假期	爸爸的假期
秘密	秘密
青春集结号	青春集结号
沉静的美国人	沉静的美国人
饭局也疯狂	饭局也疯狂
月亮偷着哭	月亮偷着哭
刺陵	刺陵
靠近我	靠近我
东陵大盗	东陵大盗
裙角飞扬的日子	裙角飞扬的日子
小站风云	小站风云
沉默是金	沉默是金
因为从有到无	因为从有到无
海街日记	海街日记
零秒出手	零秒出手
谁明浪子心	谁明浪子心
机动战士高达SEED DESTINY	机动战士高达SEED DESTINY
九月照相馆	九月照相馆
勇气	勇气
过界	过界
守护地球	守护地球
特勤精英	特勤精英
告别我	告别我
男人KTV	男人KTV
那个男人	那个男人
卫子夫	卫子夫
爱卡莉	爱卡莉
大唐玄奘	大唐玄奘
初春饰利	初春饰利
我不要再比了	我不要再比了
我要快乐	我要快乐
千王之王	千王之王
思悼	思悼
姐姐妹妹站起来	姐姐妹妹站起来
凉宫春日系列	凉宫春日系列
胭脂扣	胭脂扣
妈妈和儿子	妈妈和儿子
泡妞大宗师	泡妞大宗师
阿尔达·图兰	阿尔达·图兰
别惹我	别惹我
爸爸向前走	爸爸向前走
空城计	空城计
春天的芭蕾	春天的芭蕾
告别昨天	告别昨天
猿飞日斩	猿飞日斩
大侠阿吉	大侠阿吉
追夫三人行	追夫三人行
美人鱼	美人鱼
圆谷光彦	圆谷光彦
国防生	国防生
决战华岩寺	决战华岩寺
郎本无情	郎本无情
红豆女之恋	红豆女之恋
你们被包围了	你们被包围了
没说的话	没说的话
梦回唐朝	梦回唐朝
街头剧场	街头剧场
火之女神井儿	火之女神井儿
一个人的约会	一个人的约会
华之乱	华之乱
沈三娘	沈三娘
子夜	子夜
作对	作对
盲约	盲约
阿童木	阿童木
凄美地	凄美地
不沉的太阳	不沉的太阳
执法先锋	执法先锋
燃烧吧！欧吉桑	燃烧吧！欧吉桑
另一种温暖	另一种温暖
爱上痞子男	爱上痞子男
暖流	暖流
化作樱花树	化作樱花树
不再想念	不再想念
浓情巧克力	浓情巧克力
我想找个女朋友	我想找个女朋友
孤岛惊魂	孤岛惊魂
同名女子	同名女子
离心力	离心力
WE WILL	WE WILL
史密斯先生到华盛顿	史密斯先生到华盛顿
激情年代	激情年代
医神华佗	医神华佗
距离的拥抱	距离的拥抱
天伦	天伦
飞跃颠峰2	飞跃颠峰2
奔放的旋律	奔放的旋律
去大理	去大理
Skyfall	Skyfall
向雪祈愿	向雪祈愿
爱上巧克力	爱上巧克力
分手快乐	分手快乐
你是我的玫瑰花	你是我的玫瑰花
巴山夜雨	巴山夜雨
嫁给我吧	嫁给我吧
偷偷的哭	偷偷的哭
黄昏	黄昏
life	life
乱世豪门	乱世豪门
天使	天使
荼蘼	荼蘼
红色康乃馨	红色康乃馨
金枝欲孽	金枝欲孽
大冬瓜	大冬瓜
窝头会馆	窝头会馆
美袋命	美袋命
圣诞玫瑰	圣诞玫瑰
一条名叫旺达的鱼	一条名叫旺达的鱼
小王子	小王子
草山春晖	草山春晖
投名状	投名状
日落大道	日落大道
傻儿军长	傻儿军长
简单任务	简单任务
风之歌	风之歌
侏罗纪公园3	侏罗纪公园3
保鲜期	保鲜期
大象的证词	大象的证词
流氓蛋糕店	流氓蛋糕店
尤庚娘	尤庚娘
关于曾经	关于曾经
天机·富春山居图	天机·富春山居图
k	k
刺青	刺青
握住我的手	握住我的手
黄飞虎反五关	黄飞虎反五关
哺乳期的女人	哺乳期的女人
空中庭院	空中庭院
歌舞伎华之恋	歌舞伎华之恋
TRIPLE	TRIPLE
黄梅戏	黄梅戏
大囍之家	大囍之家
南漂	南漂
百万新娘之爱无悔	百万新娘之爱无悔
DREAM HIGH2	DREAM HIGH2
三八线	三八线
饮食男女	饮食男女
星宫莓	星宫莓
超级教师2	超级教师2
方世玉	方世玉
我的中国星	我的中国星
铁线虫入侵	铁线虫入侵
谢谢	谢谢
小李飞刀	小李飞刀
橘子果酱	橘子果酱
整蛊王	整蛊王
后来	后来
错过	错过
南国有佳人	南国有佳人
熊猫小姐和刺猬	熊猫小姐和刺猬
南北腿王	南北腿王
甲贺忍法帖	甲贺忍法帖
有故事的人	有故事的人
爱上天使	爱上天使
扇舞丹青	扇舞丹青
红色通道	红色通道
如果你不爱	如果你不爱
月黑风高	月黑风高
闯关东	闯关东
奈落	奈落
好莱坞女孩	好莱坞女孩
明天妈妈不在	明天妈妈不在
蕾蒙娜和姐姐	蕾蒙娜和姐姐
草根王	草根王
女人不要哭	女人不要哭
功夫足球	功夫足球
新梁山伯祝英台	新梁山伯祝英台
粗点心战争	粗点心战争
黑暗阴影	黑暗阴影
梦想年华大三线	梦想年华大三线
田禹治	田禹治
踏浪	踏浪
戴珍珠耳环的少女	戴珍珠耳环的少女
金瓶梅	金瓶梅
我家有喜	我家有喜
夜奔	夜奔
恋了爱了	恋了爱了
I'll Be Your Man	I'll Be Your Man
归途如虹	归途如虹
田文	田文
我喜欢你，你知道吗？	我喜欢你，你知道吗？
隐秘的激情	隐秘的激情
有没有搞错	有没有搞错
羊角花又开	羊角花又开
伤心街角恋人	伤心街角恋人
大女遭遇怪爸爸	大女遭遇怪爸爸
哲学家	哲学家
容易受伤的女人	容易受伤的女人
海边的曼彻斯特	海边的曼彻斯特
非常90后	非常90后
绝命追踪	绝命追踪
No More Drama	No More Drama
最强七友	最强七友
钱形警部	钱形警部
荷尔蒙战争	荷尔蒙战争
结婚礼服	结婚礼服
最后一次流泪	最后一次流泪
Good Boy	Good Boy
上海滩马永贞	上海滩马永贞
小鬼难缠又当家	小鬼难缠又当家
真情告白	真情告白
驱魔警察	驱魔警察
精神濒临崩溃的女人	精神濒临崩溃的女人
达坂城的姑娘	达坂城的姑娘
动什么别动感情	动什么别动感情
漂亮的李慧珍	漂亮的李慧珍
梦想贵阳	梦想贵阳
恋爱大作战	恋爱大作战
女孩别哭	女孩别哭
闯天下	闯天下
一剑镇神州	一剑镇神州
喜宴	喜宴
我是不是你最疼爱的人	我是不是你最疼爱的人
燃烧	燃烧
振荡器	振荡器
幸福来	幸福来
再战明天	再战明天
黄金拍档	黄金拍档
连城诀	连城诀
桃花宫	桃花宫
美丽之路	美丽之路
让我想一想	让我想一想
四姊妹	四姊妹
我的二哥二嫂	我的二哥二嫂
来势凶猛	来势凶猛
必杀仕事人2014	必杀仕事人2014
猫空爱情故事	猫空爱情故事
广告风云	广告风云
我的个神啊	我的个神啊
昆仑奴	昆仑奴
蛇舌	蛇舌
南泥湾	南泥湾
生死谍变	生死谍变
一发不可收拾	一发不可收拾
追逐	追逐
十字街头	十字街头
留下真情	留下真情
首都消失	首都消失
祖国万岁	祖国万岁
高智能方程式赛车	高智能方程式赛车
寂寞情歌	寂寞情歌
Oh My Lady	Oh My Lady
我是一棵小草	我是一棵小草
美好年代	美好年代
永远有多远	永远有多远
黄金密码	黄金密码
爱啦啦	爱啦啦
星际传奇	星际传奇
野兽之道	野兽之道
少年故事	少年故事
打击	打击
萌学园2：圣战再起	萌学园2：圣战再起
爱与梦飞翔	爱与梦飞翔
爱，不难	爱，不难
梦幻森林	梦幻森林
樱花雨	樱花雨
我的爱从四面八方攻击你	我的爱从四面八方攻击你
恶男宅急电	恶男宅急电
天局	天局
过去的爱情伤痕	过去的爱情伤痕
工体爱情故事	工体爱情故事
你到底爱谁	你到底爱谁
零用钱	零用钱
搜索者	搜索者
蓝色骨头	蓝色骨头
爱尔兰	爱尔兰
少林寺传奇藏经阁	少林寺传奇藏经阁
你好外星人	你好外星人
年少轻狂	年少轻狂
发达之路	发达之路
真是了不起	真是了不起
王女自鸣鼓	王女自鸣鼓
美人如画	美人如画
凶灵女一号	凶灵女一号
新女婿时代	新女婿时代
誓言	誓言
墙头马上	墙头马上
忠烈千秋	忠烈千秋
音乐现场	音乐现场
县令黄马褂	县令黄马褂
小公主萨拉	小公主萨拉
新少林寺	新少林寺
铜雀台	铜雀台
出逃的公主	出逃的公主
sos	sos
骚东坡	骚东坡
移魂都市	移魂都市
鸦片战争	鸦片战争
美人无泪	美人无泪
黑糖玛奇朵	黑糖玛奇朵
芭蕾舞天鹅湖	芭蕾舞天鹅湖
黄金传奇	黄金传奇
撒马利亚	撒马利亚
时尚汇	时尚汇
机动战士高达	机动战士高达
明珠游龙	明珠游龙
最爱	最爱
银河天使	银河天使
Eat You Up	Eat You Up
余波荡漾	余波荡漾
睡美人	睡美人
天字一号	天字一号
噢！必胜，奉顺英	噢！必胜，奉顺英
死囚之舞	死囚之舞
暗杀	暗杀
分分钟需要你	分分钟需要你
成长	成长
中国共产党党员	中国共产党党员
辣妹子	辣妹子
永不妥协	永不妥协
冬天来了	冬天来了
我很快乐	我很快乐
生死正名	生死正名
与狼共舞2	与狼共舞2
我们的勇气未满都市	我们的勇气未满都市
英雄不流泪	英雄不流泪
神无月的巫女	神无月的巫女
十五年等待候鸟	十五年等待候鸟
贝尔摩得	贝尔摩得
旅馆之嫁	旅馆之嫁
想你	想你
断点	断点
家财万贯	家财万贯
建国大业	建国大业
鲨鱼	鲨鱼
盗马记	盗马记
奇幻精灵事件簿	奇幻精灵事件簿
雀之灵	雀之灵
活得比你好	活得比你好
中川圭一	中川圭一
吉尔达	吉尔达
黄金血道	黄金血道
我们结婚了	我们结婚了
Give Peace a Chance	Give Peace a Chance
风影	风影
公家人	公家人
旋风司令韩先楚	旋风司令韩先楚
洋行里的中国小姐	洋行里的中国小姐
举鼎观画	举鼎观画
暗战2	暗战2
脚步	脚步
大雷雨	大雷雨
我是特种兵	我是特种兵
心底的中国	心底的中国
神枪手之死	神枪手之死
扁担·姑娘	扁担·姑娘
快乐的时光	快乐的时光
杀出狂人镇	杀出狂人镇
彗星美人	彗星美人
三剑客	三剑客
渔情未了	渔情未了
凤凰展翅	凤凰展翅
左右	左右
向幸福出发	向幸福出发
警界线	警界线
为你	为你
杀戒	杀戒
交涉人	交涉人
即使讨厌也要再来一次	即使讨厌也要再来一次
正者无敌	正者无敌
追风少年	追风少年
极地营救	极地营救
伊丽莎白·马布里	伊丽莎白·马布里
白龙马	白龙马
异形	异形
走进新时代	走进新时代
七亿新娘	七亿新娘
尖锋之烈焰青春	尖锋之烈焰青春
梅尔菲·樱叶	梅尔菲·樱叶
出埃及记	出埃及记
生死血符	生死血符
我们俩	我们俩
蝾螈道士和影子操作团	蝾螈道士和影子操作团
鬼叫春	鬼叫春
爱情公寓3	爱情公寓3
大染坊续	大染坊续
等一分钟	等一分钟
我有一个梦	我有一个梦
股疯	股疯
王牌大明星	王牌大明星
谈感情	谈感情
美人邦	美人邦
智勇新警界	智勇新警界
亚当	亚当
夏目友人帐	夏目友人帐
三国	三国
白色巨塔	白色巨塔
这该死的爱	这该死的爱
盛世好风光	盛世好风光
Baha	Baha
中国式亲情	中国式亲情
和平年代	和平年代
The Way I Are	The Way I Are
你不能爱我	你不能爱我
啥人嫁拨伊	啥人嫁拨伊
外出	外出
情歌好听却难唱	情歌好听却难唱
彼岸1945	彼岸1945
战栗空间	战栗空间
小丈夫	小丈夫
丸藤亮	丸藤亮
我喜欢上你时的内心活动	我喜欢上你时的内心活动
无心法师Ⅱ	无心法师Ⅱ
机械师	机械师
十七岁的雨季	十七岁的雨季
博物馆奇妙夜	博物馆奇妙夜
七里香	七里香
烽火儿女情	烽火儿女情
后宫那些事儿	后宫那些事儿
幸福满满	幸福满满
爱，有你来作伴	爱，有你来作伴
刘老庄八十二壮士	刘老庄八十二壮士
红酒俏佳人	红酒俏佳人
蝙蝠侠	蝙蝠侠
野草闲花	野草闲花
守护丽人	守护丽人
警察日记	警察日记
遇见我	遇见我
柠檬可乐	柠檬可乐
飞絮	飞絮
我们可以相爱么	我们可以相爱么
超脱	超脱
怪侠欧阳德	怪侠欧阳德
天堂可以等待	天堂可以等待
情陷夜中环2	情陷夜中环2
烈火凤凰	烈火凤凰
记得	记得
猛鬼差馆	猛鬼差馆
罗恩·韦斯莱	罗恩·韦斯莱
月亮女儿	月亮女儿
奇迹MU	奇迹MU
sign	sign
黎明的眼睛	黎明的眼睛
蓝色宇宙	蓝色宇宙
奥特Q黑暗幻想	奥特Q黑暗幻想
anaconda	anaconda
凤凰二乔	凤凰二乔
7777次的坠落	7777次的坠落
Blank Space	Blank Space
封神榜之武王伐纣	封神榜之武王伐纣
能人冯天贵	能人冯天贵
巨人传	巨人传
山水贵客	山水贵客
夺命推理	夺命推理
幸福小丈夫	幸福小丈夫
职场是个技术活	职场是个技术活
摇滚舞台	摇滚舞台
超级大神探	超级大神探
Must Listen	Must Listen
幸福不远	幸福不远
皇太子的初恋	皇太子的初恋
洛城机密	洛城机密
外星小子哆布哆	外星小子哆布哆
媳妇的美好时代	媳妇的美好时代
月宫亚由	月宫亚由
赤色危机	赤色危机
爱没有错	爱没有错
战火中的花蕾	战火中的花蕾
西游记之大圣归来	西游记之大圣归来
迷失东京	迷失东京
戏说台湾	戏说台湾
That's my goal	That's my goal
一路夫妻	一路夫妻
寂寞不痛	寂寞不痛
两个男人	两个男人
免费电话	免费电话
小永远	小永远
goodbye my lover	goodbye my lover
怨鬼之家	怨鬼之家
美丽中国走起来	美丽中国走起来
滇西1944	滇西1944
寒江雪	寒江雪
人生至上	人生至上
阳光列车	阳光列车
大唐双龙传	大唐双龙传
昆剧	昆剧
复活的三叶虫	复活的三叶虫
二次曝光	二次曝光
秋江	秋江
狼	狼
绿巨人	绿巨人
玉碎	玉碎
云深不知处	云深不知处
倭寇的踪迹	倭寇的踪迹
学习之神	学习之神
Littlest things	Littlest things
Bubble Pop!	Bubble Pop!
残缺	残缺
秘密特工	秘密特工
鬼吹灯之寻龙诀	鬼吹灯之寻龙诀
暴风雨	暴风雨
如何吃炸毛虫	如何吃炸毛虫
年晚钱	年晚钱
古船·女人和网	古船·女人和网
社会摇	社会摇
忠奸人	忠奸人
SUMMER NUDE	SUMMER NUDE
好想好想谈恋爱	好想好想谈恋爱
叶子	叶子
情迷海上花	情迷海上花
记忆的证明	记忆的证明
小魔仙之黑魔法来袭	小魔仙之黑魔法来袭
你在烦恼什么	你在烦恼什么
一个人想着一个人	一个人想着一个人
为爱痴狂	为爱痴狂
爱情乞丐	爱情乞丐
天龙八部	天龙八部
女人何苦为难女人	女人何苦为难女人
超有感	超有感
少年英雄方世玉	少年英雄方世玉
他和她	他和她
龙门飞甲	龙门飞甲
谭某某	谭某某
狙击手	狙击手
绍兴师爷	绍兴师爷
踮起脚尖吻到爱	踮起脚尖吻到爱
东北剿匪记	东北剿匪记
The Man Who Can't Be Moved	The Man Who Can't Be Moved
独家记忆	独家记忆
圆满	圆满
十面埋伏	十面埋伏
暴雨梨花	暴雨梨花
欲望之翼	欲望之翼
秦王李世民	秦王李世民
沉默	沉默
犬夜叉	犬夜叉
默默数	默默数
假女真情	假女真情
毛岸英	毛岸英
才子佳人乾隆皇	才子佳人乾隆皇
情满雪阳花	情满雪阳花
了不起的盖茨比	了不起的盖茨比
替身	替身
怪物	怪物
乾坤福寿镜	乾坤福寿镜
Forgot About Dre	Forgot About Dre
快乐ELIFE	快乐ELIFE
古惑仔之出位	古惑仔之出位
宽恕	宽恕
剩余公主	剩余公主
心酸的浪漫	心酸的浪漫
亲爱的朋友	亲爱的朋友
青春的约定	青春的约定
大爱无声	大爱无声
Hello!树先生	Hello!树先生
做头	做头
伤痕	伤痕
步步惊情	步步惊情
找找爱	找找爱
炫境	炫境
黑杰克	黑杰克
官场斗	官场斗
一直很安静	一直很安静
草原春来早	草原春来早
魔幻手机2傻妞归来	魔幻手机2傻妞归来
小时代3：刺金时代	小时代3：刺金时代
宏愿	宏愿
森山中教习所	森山中教习所
奇怪的家政妇	奇怪的家政妇
逆光	逆光
知县叶光明	知县叶光明
新梁山伯与祝英台	新梁山伯与祝英台
九尾狐外传	九尾狐外传
一世牵挂	一世牵挂
要抱抱	要抱抱
太多	太多
杨贵妃	杨贵妃
帅管家教你变身时尚名媛	帅管家教你变身时尚名媛
江南之南	江南之南
理发师陶德	理发师陶德
云巅之上	云巅之上
流金岁月	流金岁月
黑色名单	黑色名单
狐狸的夏天	狐狸的夏天
Sexy, Free & Single	Sexy, Free & Single
终极恶女	终极恶女
荆棘鸟	荆棘鸟
神的病历簿	神的病历簿
妇产科	妇产科
大女当嫁	大女当嫁
团圆饭	团圆饭
奔跑吧，依兰	奔跑吧，依兰
life show	life show
爱的创可贴	爱的创可贴
here i am	here i am
假行僧	假行僧
灌篮高手	灌篮高手
山樱	山樱
一个鬼子都不留	一个鬼子都不留
吃元宵	吃元宵
嫁给中国人	嫁给中国人
因为遇见你	因为遇见你
杨家将	杨家将
战上海	战上海
致命复活	致命复活
李小龙：勇士的旅程	李小龙：勇士的旅程
远坂时臣	远坂时臣
人民的名义	人民的名义
神秘空	神秘空
虫不知	虫不知
魔法师的学徒	魔法师的学徒
樱庭葵	樱庭葵
法印	法印
陈小春	陈小春
爱情正在直播	爱情正在直播
艾克托尔·路易·柏辽兹	艾克托尔·路易·柏辽兹
那滋味	那滋味
尊严	尊严
一个勺子	一个勺子
再不相爱就老了	再不相爱就老了
师奶股神	师奶股神
昨天	昨天
平原烽火	平原烽火
光辉岁月	光辉岁月
胡狼来了	胡狼来了
七步干戈	七步干戈
女继承人	女继承人
超市特工	超市特工
快乐阿拉蕾	快乐阿拉蕾
满清十三皇朝	满清十三皇朝
漫长的婚约	漫长的婚约
本山快乐营	本山快乐营
凯莉·布鲁克	凯莉·布鲁克
我就是…ella陈嘉桦	我就是…ella陈嘉桦
巫山盟	巫山盟
惊世骇俗	惊世骇俗
全力青春	全力青春
如影随形	如影随形
广开土大王	广开土大王
信念	信念
Play 我呸！	Play 我呸！
红红好姑娘	红红好姑娘
后山日先照	后山日先照
七大罪	七大罪
日本沉没	日本沉没
女生宿舍那点事	女生宿舍那点事
西楚霸王	西楚霸王
咒怨	咒怨
走西口	走西口
丰年	丰年
You've Got A Friend	You've Got A Friend
百慕大三角	百慕大三角
新白发魔女传	新白发魔女传
家	家
再见X先生	再见X先生
失去的周末	失去的周末
astral	astral
舞娘	舞娘
跟踪孔令学	跟踪孔令学
百老汇音乐剧	百老汇音乐剧
飞翔	飞翔
枪花	枪花
complicated	complicated
再世姻缘	再世姻缘
单车	单车
天涯织女	天涯织女
童年的小摇车	童年的小摇车
关在家	关在家
顶级怪盗	顶级怪盗
油脂	油脂
红牡丹	红牡丹
淑女之家	淑女之家
年少无知	年少无知
幸福出租车	幸福出租车
草鞋状元郎	草鞋状元郎
打电话	打电话
我外母唔系人	我外母唔系人
红龙	红龙
武士白东秀	武士白东秀
名剑风流	名剑风流
大清盐商	大清盐商
家族之间何必这样	家族之间何必这样
保留	保留
one	one
范绍增	范绍增
智胜鲜师	智胜鲜师
极品家丁	极品家丁
星月童话	星月童话
创世纪Ⅱ天地有情	创世纪Ⅱ天地有情
江湖接班人	江湖接班人
两仪式	两仪式
囧人的幸福生活	囧人的幸福生活
永不回头	永不回头
拥抱爱	拥抱爱
五朵金花	五朵金花
刘海戏金蟾	刘海戏金蟾
七月初七	七月初七
家族诞生	家族诞生
血溅金沙湾	血溅金沙湾
评价女王	评价女王
百变星君	百变星君
喜耕田的故事	喜耕田的故事
红烛光	红烛光
蒲松龄	蒲松龄
Only You只有您	Only You只有您
天天天蓝	天天天蓝
真爱惹麻烦	真爱惹麻烦
铁面无私	铁面无私
刀光虎影	刀光虎影
新京城四少	新京城四少
what U need	what U need
少林僧兵	少林僧兵
绝世天劫	绝世天劫
我们的幸福时光	我们的幸福时光
三伏天	三伏天
聂荣臻	聂荣臻
天生缘分	天生缘分
boyfriend	boyfriend
扑克王	扑克王
花田囍事2010	花田囍事2010
南少林	南少林
境界的彼方	境界的彼方
大叔很跩	大叔很跩
神风怪盗贞德	神风怪盗贞德
快乐星球之逃出星球	快乐星球之逃出星球
半斤八两	半斤八两
美丽的心灵	美丽的心灵
Alejandro	Alejandro
塞壬	塞壬
亲密的陷阱	亲密的陷阱
不当交易	不当交易
火红的柿子	火红的柿子
对你爱不完	对你爱不完
生活有点甜	生活有点甜
芳心终结者	芳心终结者
锦绣缘华丽冒险	锦绣缘华丽冒险
世界	世界
防火墙5788	防火墙5788
雪茫危机	雪茫危机
日出	日出
四月望雨	四月望雨
太极侠	太极侠
夜叉	夜叉
狠毒的女人	狠毒的女人
男人制造	男人制造
危险的蜜月旅行	危险的蜜月旅行
有爱任性	有爱任性
铿锵玫瑰	铿锵玫瑰
中国合伙人	中国合伙人
刀锋乱世情	刀锋乱世情
马斯·休斯	马斯·休斯
爱情命运号	爱情命运号
风的季节	风的季节
真心英雄	真心英雄
向着幸福前进	向着幸福前进
追凶者也	追凶者也
外滩18号	外滩18号
我的父亲我的兵	我的父亲我的兵
寒蝉鸣泣之时	寒蝉鸣泣之时
独生子女的婆婆妈妈	独生子女的婆婆妈妈
无法归类	无法归类
翼	翼
青花瓷	青花瓷
在太阳星等你	在太阳星等你
桂花巷	桂花巷
绽放爱	绽放爱
邻居大战	邻居大战
最美的你	最美的你
济南战役	济南战役
沙家浜	沙家浜
爱你和从前一样	爱你和从前一样
冲上云霄	冲上云霄
开国	开国
相叶マナブ	相叶マナブ
八仙全传	八仙全传
我是愤怒	我是愤怒
我的母亲手记	我的母亲手记
寻找刘三姐	寻找刘三姐
致青春	致青春
伪装夫妇	伪装夫妇
中国式关系	中国式关系
五河琴里	五河琴里
你丫闭嘴	你丫闭嘴
相濡以沫	相濡以沫
桂小太郎	桂小太郎
公民凯恩	公民凯恩
爱我@别走	爱我@别走
悠悠寸草心	悠悠寸草心
催眠	催眠
朽木露琪亚	朽木露琪亚
日本人不知道的日语	日本人不知道的日语
巴啦啦小魔仙	巴啦啦小魔仙
爱笑的眼睛	爱笑的眼睛
马文的战争	马文的战争
星光下的梦想	星光下的梦想
世界上最难的恋爱	世界上最难的恋爱
Thriller	Thriller
归心似箭	归心似箭
毛骗	毛骗
笑傲江湖	笑傲江湖
武工队传奇	武工队传奇
白天不懂夜的黑	白天不懂夜的黑
简单爱你	简单爱你
dark angel	dark angel
发展受阻	发展受阻
上海快车	上海快车
保卫孙子	保卫孙子
功夫战斗机	功夫战斗机
乌盆记	乌盆记
美女的烦恼	美女的烦恼
吻	吻
秋叶原@DEEP	秋叶原@DEEP
蔷花，红莲	蔷花，红莲
只要你过得比我好	只要你过得比我好
绣春刀	绣春刀
断箭	断箭
翻滚吧，蛋炒饭	翻滚吧，蛋炒饭
千金归来	千金归来
寂寞沙洲冷	寂寞沙洲冷
Hit Me	Hit Me
欢颜	欢颜
SPEC	SPEC
带刀女捕快	带刀女捕快
列车上的陌生人	列车上的陌生人
隔壁女生的日常	隔壁女生的日常
豪情三剑客	豪情三剑客
警察夫人2	警察夫人2
盘妻索妻	盘妻索妻
你在他乡	你在他乡
我的家	我的家
快乐星球第五部	快乐星球第五部
饥饿游戏	饥饿游戏
巾帼大将军	巾帼大将军
幸福兑换券	幸福兑换券
隋唐演义	隋唐演义
值得为你	值得为你
nice body	nice body
伤心的不只是你	伤心的不只是你
三生三世十里桃花	三生三世十里桃花
麻辣婆媳	麻辣婆媳
欢乐满人间	欢乐满人间
挥着翅膀的女孩	挥着翅膀的女孩
燃烧岁月	燃烧岁月
麻辣芳邻	麻辣芳邻
代号九耳犬	代号九耳犬
野鹅敢死队	野鹅敢死队
牵挂	牵挂
巨人之星	巨人之星
上海新娘	上海新娘
钻石的眼泪	钻石的眼泪
英国病人	英国病人
你敢不敢	你敢不敢
婆婆来了	婆婆来了
川东游击队	川东游击队
红河哈尼族彝族自治州	红河哈尼族彝族自治州
捍卫	捍卫
原野	原野
皇粮胡同19号	皇粮胡同19号
降龙传说	降龙传说
男生日记	男生日记
张好古	张好古
天龙八部之六脉神剑、虚竹传奇	天龙八部之六脉神剑、虚竹传奇
普里兹家族的荣誉	普里兹家族的荣誉
roly poly	roly poly
危险关系	危险关系
季节	季节
Rising Hope	Rising Hope
陀枪师姐II	陀枪师姐II
辛德勒的名单	辛德勒的名单
无问题	无问题
卖布头	卖布头
她	她
Saint Francis	Saint Francis
我的灵界男友	我的灵界男友
三寸天堂	三寸天堂
红槐花	红槐花
曾良	曾良
碧海情天	碧海情天
怀念战友	怀念战友
宛若微风	宛若微风
爱我你就抱抱我	爱我你就抱抱我
江湖小子	江湖小子
求佛	求佛
正午	正午
别说我的眼泪你无所谓	别说我的眼泪你无所谓
女人的颜色	女人的颜色
爱的问候	爱的问候
夏洛特的网	夏洛特的网
爱不后悔	爱不后悔
搜神记	搜神记
爱情跑道	爱情跑道
爱的延续	爱的延续
三个火枪手	三个火枪手
蒲公英的梦想	蒲公英的梦想
租妻成婚	租妻成婚
放狠爱	放狠爱
Princess	Princess
恋风恋歌	恋风恋歌
光荣的世界	光荣的世界
义兄弟	义兄弟
给爱丽丝的奇迹	给爱丽丝的奇迹
暗流	暗流
钟无艳	钟无艳
is上帝的恶作剧	is上帝的恶作剧
再见爱人	再见爱人
陪你长大	陪你长大
永不瞑目	永不瞑目
英雄戟之影子战士	英雄戟之影子战士
美丽新世界	美丽新世界
曾经的梦想	曾经的梦想
亮晶晶概念乐团	亮晶晶概念乐团
意	意
Greatest Love Of All	Greatest Love Of All
别让爱情走了样	别让爱情走了样
屠城血证	屠城血证
HeartCatch光之美少女！	HeartCatch光之美少女！
球爱咖啡屋	球爱咖啡屋
你的背包	你的背包
草地状元	草地状元
相信爱	相信爱
歌之☆王子殿下♪ 真爱1000%	歌之☆王子殿下♪ 真爱1000%
编辑部的故事	编辑部的故事
I Kissed A Girl	I Kissed A Girl
南行记	南行记
与敌同行	与敌同行
校园卧底	校园卧底
养鸭人家	养鸭人家
东风破	东风破
空	空
西游记后传	西游记后传
同居	同居
飞刀手	飞刀手
欣怡	欣怡
灵欲春宵	灵欲春宵
光荣之路	光荣之路
雷霆扫毒	雷霆扫毒
敢爱	敢爱
栉枝实乃梨	栉枝实乃梨
红色恋人	红色恋人
父亲的身份	父亲的身份
我在锡林郭勒等你	我在锡林郭勒等你
舞出我人生	舞出我人生
心墙	心墙
娥	娥
一仆二主	一仆二主
一眉道人	一眉道人
时之扉	时之扉
鹿港小镇	鹿港小镇
比天空还远	比天空还远
崔莺莺	崔莺莺
冒牌老爸	冒牌老爸
无价之宝	无价之宝
好汉歌	好汉歌
深呼吸	深呼吸
反转地球	反转地球
我就在你面前	我就在你面前
今生有约	今生有约
综艺大观	综艺大观
双面体	双面体
煎熬	煎熬
锦衣夜行	锦衣夜行
悄悄话	悄悄话
林则徐	林则徐
看我72变	看我72变
看见味道的少女	看见味道的少女
一十木音也	一十木音也
人生遥控器	人生遥控器
鸭王	鸭王
哈萨雅琪	哈萨雅琪
神探包青天	神探包青天
震撼鲜师	震撼鲜师
自由搏击	自由搏击
剧风行动	剧风行动
让世界充满爱	让世界充满爱
两个人	两个人
又是吴海英	又是吴海英
给深爱的你	给深爱的你
国色天香	国色天香
无法再见的时光	无法再见的时光
月光	月光
幸福港湾	幸福港湾
72家租客	72家租客
红颜	红颜
女医·明妃传	女医·明妃传
Three Days	Three Days
暴力街区13：终极	暴力街区13：终极
追妻三人行	追妻三人行
abc君	abc君
山重水复	山重水复
何时是读书天	何时是读书天
杀狼花	杀狼花
橘子郡男孩	橘子郡男孩
草原上的风	草原上的风
歌手价值	歌手价值
三个半女人	三个半女人
女人如烟	女人如烟
未知死亡	未知死亡
我还是很想她	我还是很想她
你是最爱	你是最爱
还是要幸福	还是要幸福
一如既往	一如既往
换掉	换掉
选择	选择
天使在人间	天使在人间
大汉天子	大汉天子
唱给黄河听	唱给黄河听
黄海	黄海
黑白道	黑白道
24个比利	24个比利
铁娘子	铁娘子
还我本色	还我本色
淘婚记	淘婚记
花木兰传奇	花木兰传奇
圣女之歌	圣女之歌
黑衣人	黑衣人
最后的情书	最后的情书
我的兄弟姐妹	我的兄弟姐妹
10亿	10亿
黄金背后	黄金背后
野王	野王
曹操	曹操
暖春	暖春
为爱放手	为爱放手
焚心以火	焚心以火
偶然路过的街	偶然路过的街
撒娇女王	撒娇女王
插翅难逃	插翅难逃
旅行的意义	旅行的意义
必娶女人	必娶女人
一不小心爱上你	一不小心爱上你
天才碰麻瓜	天才碰麻瓜
大团圆	大团圆
三看御妹	三看御妹
应召女郎	应召女郎
拥抱每一刻花火	拥抱每一刻花火
掌声响起来	掌声响起来
坏爱情	坏爱情
骄阳似我	骄阳似我
钟爱一生	钟爱一生
勾勾手	勾勾手
聂小倩	聂小倩
无限挑战	无限挑战
皮拉夫	皮拉夫
历史转折中的邓小平	历史转折中的邓小平
life is like a boat	life is like a boat
百万宝	百万宝
幸福来敲门	幸福来敲门
尚道上学去	尚道上学去
枕边有张脸	枕边有张脸
宝贝妈妈宝贝女	宝贝妈妈宝贝女
野性的证明	野性的证明
爱在燃烧	爱在燃烧
何日君再来	何日君再来
陀飞轮	陀飞轮
红星照耀中国	红星照耀中国
妈妈长角了	妈妈长角了
独人捉迷藏	独人捉迷藏
女婿大人	女婿大人
十八个手印	十八个手印
pound the alarm	pound the alarm
跟踪	跟踪
彩虹女神	彩虹女神
Without you	Without you
真田弦一郎	真田弦一郎
兰博之子	兰博之子
痒	痒
少林寺	少林寺
暖暖	暖暖
楚韵	楚韵
周围	周围
爸爸妈妈	爸爸妈妈
花开花谢花满天	花开花谢花满天
玻璃鞋	玻璃鞋
大武生	大武生
内当家	内当家
午夜巴黎	午夜巴黎
神州侠侣	神州侠侣
威尼斯迷路	威尼斯迷路
叶落长安	叶落长安
解忧公主	解忧公主
木兰诗篇	木兰诗篇
东方	东方
山中风	山中风
邂逅	邂逅
burning	burning
热血商人	热血商人
男人最痛	男人最痛
今天我休息	今天我休息
飞向爱	飞向爱
精忠岳飞	精忠岳飞
20岁的结婚	20岁的结婚
失空斩	失空斩
马克斯之山	马克斯之山
大醉侠	大醉侠
隔墙花	隔墙花
乖乖女是大明星	乖乖女是大明星
bubbly	bubbly
又见一帘幽梦	又见一帘幽梦
黑白配	黑白配
惊天岳雷	惊天岳雷
英雄联盟	英雄联盟
你快回来	你快回来
龙威父子	龙威父子
桃花小妹	桃花小妹
四百击	四百击
赤线地带	赤线地带
哈姆雷特	哈姆雷特
撞车	撞车
意外的旅程	意外的旅程
新永不瞑目	新永不瞑目
画花	画花
夏娃的诱惑	夏娃的诱惑
good bye	good bye
流浪花	流浪花
东北往事之破马张飞	东北往事之破马张飞
心里的孩子	心里的孩子
Super Daddy 烈	Super Daddy 烈
破风	破风
b420	b420
天使爱美丽	天使爱美丽
绫波丽	绫波丽
异域	异域
心急吃不了热豆腐	心急吃不了热豆腐
与龙共舞	与龙共舞
在光化门	在光化门
我在春天等你	我在春天等你
Kiss My Lips	Kiss My Lips
康美之恋	康美之恋
烽火赤焰万里情	烽火赤焰万里情
永远幸福	永远幸福
梦宝谷	梦宝谷
摇滚藏獒	摇滚藏獒
梦幻田园	梦幻田园
沧海一声笑	沧海一声笑
枪王之王	枪王之王
告别囧途	告别囧途
遗忘时间的爱情	遗忘时间的爱情
打工奇遇	打工奇遇
制服真碍事	制服真碍事
西由宇子	西由宇子
大风歌	大风歌
神汉流氓	神汉流氓
桃花劫	桃花劫
玛格丽特·撒切尔：通往芬奇利之路	玛格丽特·撒切尔：通往芬奇利之路
月满西楼	月满西楼
空港	空港
利箭纵横	利箭纵横
一代枭雄	一代枭雄
三叶草	三叶草
一条路	一条路
国际刑警1997	国际刑警1997
香水佳人	香水佳人
孝庄秘史	孝庄秘史
吴清源	吴清源
盗梦者	盗梦者
白天鹅	白天鹅
天涯歌女	天涯歌女
我们复婚吧	我们复婚吧
武人时代	武人时代
日番谷冬狮郎	日番谷冬狮郎
为什么你背着我爱别人	为什么你背着我爱别人
Don't Say No	Don't Say No
幕末太阳传	幕末太阳传
汉宫飞燕	汉宫飞燕
激情燃烧的岁月	激情燃烧的岁月
爱你千万次	爱你千万次
公元2000	公元2000
折子戏	折子戏
箭在弦上	箭在弦上
每天爱您8小时	每天爱您8小时
浪人情歌	浪人情歌
铁血刀锋	铁血刀锋
抒情歌	抒情歌
路边董事长	路边董事长
陌上寸草	陌上寸草
鸽子哨	鸽子哨
交锋	交锋
烂命鸳鸯	烂命鸳鸯
梦幻家园	梦幻家园
长恨歌	长恨歌
我是老师	我是老师
珊瑚海	珊瑚海
美食祈祷和恋爱	美食祈祷和恋爱
那年春天	那年春天
Happy Together	Happy Together
郑道传	郑道传
青蛙王子	青蛙王子
绿头苍蝇	绿头苍蝇
出租车司机	出租车司机
我的寂寞无人能懂	我的寂寞无人能懂
茉莉花开	茉莉花开
激情过后	激情过后
多伦多猛龙队	多伦多猛龙队
小生怕怕	小生怕怕
编织的女孩	编织的女孩
17岁的天空	17岁的天空
徽娘宛心	徽娘宛心
美国X档案	美国X档案
Bad Boy	Bad Boy
1701	1701
小儿难养	小儿难养
大嫁风尚	大嫁风尚
我的极品老妈	我的极品老妈
Cry Me A River	Cry Me A River
火遮眼	火遮眼
罗通	罗通
罪恶之城	罪恶之城
魔法少女小圆	魔法少女小圆
smile	smile
奸情	奸情
天娇	天娇
需要浪漫2012	需要浪漫2012
谁的眼泪在飞	谁的眼泪在飞
南北醉拳	南北醉拳
Rock N Roll	Rock N Roll
野比大雄	野比大雄
科学超电磁炮	科学超电磁炮
桐柏英雄	桐柏英雄
卡拉屋企	卡拉屋企
飞跃巅峰	飞跃巅峰
东西宫略	东西宫略
燃情岁月	燃情岁月
伊吹风子	伊吹风子
二胎	二胎
谁是卧底之王牌	谁是卧底之王牌
天天想你	天天想你
紫禁惊雷	紫禁惊雷
世上哪有树缠藤	世上哪有树缠藤
老处女日记	老处女日记
现代美女	现代美女
玫瑰梦	玫瑰梦
宽松世代又如何	宽松世代又如何
Voice of EARTH	Voice of EARTH
良家妇女	良家妇女
双子星	双子星
失恋高跟鞋	失恋高跟鞋
苏幕遮	苏幕遮
江苏三笑集团有限公司	江苏三笑集团有限公司
林家食铺	林家食铺
Niggas In Paris	Niggas In Paris
慢慢懂	慢慢懂
潘作良	潘作良
降临	降临
绝望的主妇	绝望的主妇
八珍汤	八珍汤
蝶离飞	蝶离飞
传闻	传闻
忠诚与背叛	忠诚与背叛
不请自来	不请自来
云的画	云的画
My Way	My Way
超人：钢铁之躯	超人：钢铁之躯
悲伤时唱首歌	悲伤时唱首歌
流浪到淡水	流浪到淡水
呆呆向前冲	呆呆向前冲
我知女人心	我知女人心
一百种孤独的理由	一百种孤独的理由
王宝钏与薛平贵	王宝钏与薛平贵
道北人	道北人
请茶歌	请茶歌
美国恐怖故事	美国恐怖故事
我阿妈系黑玫瑰	我阿妈系黑玫瑰
烛光里的妈妈	烛光里的妈妈
光速跑者21号	光速跑者21号
小星星	小星星
亲子情未了	亲子情未了
五月情怀	五月情怀
凌晨一点	凌晨一点
时尚健康	时尚健康
银河碧波	银河碧波
最后胜利	最后胜利
杀生	杀生
有梦好甜蜜	有梦好甜蜜
Ⅱ	Ⅱ
春风	春风
伊丽莎白	伊丽莎白
儿女情	儿女情
最佳前男友	最佳前男友
剑侠情缘之藏剑山庄	剑侠情缘之藏剑山庄
亿万继承人	亿万继承人
本色	本色
不成问题的问题	不成问题的问题
兵哥	兵哥
轻轻地告诉你	轻轻地告诉你
龙珠GT	龙珠GT
错点鸳鸯	错点鸳鸯
我爱太空人	我爱太空人
虾球传	虾球传
人间正道是沧桑	人间正道是沧桑
大劈棺	大劈棺
爱作梦的人	爱作梦的人
爱情转移	爱情转移
猛鬼霸王花	猛鬼霸王花
原谅	原谅
北方的金丝雀	北方的金丝雀
大侦探福尔摩斯	大侦探福尔摩斯
缘之烩	缘之烩
omg	omg
爱情自有天意	爱情自有天意
爱上女蒲团	爱上女蒲团
爱情来了，请打卡	爱情来了，请打卡
I'm Back	I'm Back
硬汉2：奉陪到底	硬汉2：奉陪到底
比克大魔王	比克大魔王
洛城生死恋	洛城生死恋
Code Geass 反叛的鲁路修	Code Geass 反叛的鲁路修
午夜情	午夜情
功夫厨神	功夫厨神
凡尔赛玫瑰	凡尔赛玫瑰
旗袍	旗袍
三万英尺	三万英尺
小梅医生	小梅医生
海滩男孩	海滩男孩
草莓棉花糖	草莓棉花糖
龙马传	龙马传
小逸	小逸
你眼中的我	你眼中的我
表错七日情	表错七日情
玻璃之城	玻璃之城
惬意孤单	惬意孤单
你的Noir	你的Noir
泽渡真琴	泽渡真琴
不如吃茶去	不如吃茶去
偷走我的心	偷走我的心
失恋保险	失恋保险
执迷不悔	执迷不悔
秘密情人	秘密情人
你爱写歌	你爱写歌
维多利亚的秘密时尚秀	维多利亚的秘密时尚秀
谢文东	谢文东
西游记之锁妖封魔塔	西游记之锁妖封魔塔
beautiful	beautiful
你唱过的歌	你唱过的歌
返老还童	返老还童
成成烽火之金戈铁马	成成烽火之金戈铁马
大珍珠	大珍珠
陆小凤与花满楼	陆小凤与花满楼
咱们的牛百岁	咱们的牛百岁
我活着的理由	我活着的理由
文天祥	文天祥
破浪人生	破浪人生
激情燃烧的岁月2	激情燃烧的岁月2
大漠苍狼	大漠苍狼
雨一直下	雨一直下
帝女花	帝女花
如月伸太郎	如月伸太郎
秋水伊人	秋水伊人
小鸡小鸡	小鸡小鸡
太白山脉	太白山脉
乞丐郎君千金女	乞丐郎君千金女
潜龙轰天	潜龙轰天
福满人间	福满人间
300勇士：帝国崛起	300勇士：帝国崛起
就要幸福了	就要幸福了
道顿堀川	道顿堀川
学校2	学校2
美丽的大脚	美丽的大脚
听见你的声音	听见你的声音
荆轲刺秦王	荆轲刺秦王
阿波罗	阿波罗
赌神	赌神
回心转意	回心转意
神雕侠侣	神雕侠侣
欢乐中国年	欢乐中国年
莫让情两难	莫让情两难
马超	马超
80后	80后
我只是一个傻瓜	我只是一个傻瓜
新边城浪子	新边城浪子
即日启程	即日启程
陆小凤之凤舞九天	陆小凤之凤舞九天
沪上风云	沪上风云
逆转女王	逆转女王
炮神	炮神
聊斋	聊斋
车票	车票
歌魂	歌魂
爱X无限大	爱X无限大
缘字诀	缘字诀
薛丁山与樊梨花	薛丁山与樊梨花
爱情悠悠药草香	爱情悠悠药草香
一样爱着你	一样爱着你
相约星期六	相约星期六
寂寞的恋人啊	寂寞的恋人啊
Good Bye Baby	Good Bye Baby
一千零一夜	一千零一夜
绝代双骄	绝代双骄
约翰·亚当斯	约翰·亚当斯
和你在一起	和你在一起
正·青春	正·青春
她从雾中来	她从雾中来
平泽唯	平泽唯
金州勇士队	金州勇士队
爱了为什么要离开	爱了为什么要离开
天才麻将少女	天才麻将少女
宫S	宫S
血证	血证
零度战姬	零度战姬
day by day	day by day
女人不是妖	女人不是妖
音为爱	音为爱
海派甜心	海派甜心
亲密搭档	亲密搭档
诡魇	诡魇
我用所有报答爱	我用所有报答爱
水百合	水百合
宫锁心玉	宫锁心玉
恰同学少年	恰同学少年
古今大战秦俑情	古今大战秦俑情
天堂	天堂
银河系漫游指南	银河系漫游指南
草原恋	草原恋
大丫鬟	大丫鬟
欢迎爱光临	欢迎爱光临
叶天士	叶天士
他和她的事情	他和她的事情
古畑任三郎	古畑任三郎
零点杀机	零点杀机
硬汉奶爸	硬汉奶爸
扫毒	扫毒
眼泪太年轻	眼泪太年轻
Bella同名专辑	Bella同名专辑
好爹好娘	好爹好娘
神的晚餐	神的晚餐
四大名捕	四大名捕
净土	净土
女人俱乐部	女人俱乐部
回到爱以前	回到爱以前
四个女仔三个Bar	四个女仔三个Bar
成人童话	成人童话
车站	车站
永不言败	永不言败
火战车	火战车
毁灭爱情	毁灭爱情
热血之路	热血之路
女人当官	女人当官
明星实习生	明星实习生
恨情歌	恨情歌
水墨丹青	水墨丹青
青之炎	青之炎
盛夏的猎户座	盛夏的猎户座
借你疗伤	借你疗伤
澳门风云	澳门风云
人到四十	人到四十
越单纯越幸福	越单纯越幸福
菜鸟	菜鸟
春·日光	春·日光
报菜名	报菜名
为你而活	为你而活
古泉一树	古泉一树
入云龙公孙胜	入云龙公孙胜
朋友一场	朋友一场
弹剑记	弹剑记
碟中谍	碟中谍
借问英雄何处	借问英雄何处
耀舞长安	耀舞长安
动静	动静
007之择日而亡	007之择日而亡
真的很在乎	真的很在乎
红娘子	红娘子
兄弟兄弟	兄弟兄弟
bonamana	bonamana
Dramatic	Dramatic
梦的衣裳	梦的衣裳
长沙保卫战	长沙保卫战
狐妻	狐妻
天公疼好人	天公疼好人
分手日记	分手日记
who says	who says
返城年代	返城年代
剑与花	剑与花
山狗	山狗
天仙配后传	天仙配后传
幸福论	幸福论
ATARU	ATARU
神打	神打
乌尔奇奥拉·西法	乌尔奇奥拉·西法
the king	the king
大侠沈胜衣	大侠沈胜衣
少林武王	少林武王
孤儿怨	孤儿怨
美国丽人	美国丽人
真爱找麻烦	真爱找麻烦
很爱很爱你	很爱很爱你
左右不逢源	左右不逢源
燕归来	燕归来
王牌特工：特工学院	王牌特工：特工学院
BJ单身日记2：理性边缘	BJ单身日记2：理性边缘
八卦神探	八卦神探
鬼邻人	鬼邻人
拼命三娘	拼命三娘
香魂女	香魂女
上海森林	上海森林
云霄飞车	云霄飞车
好姑娘	好姑娘
春天华尔兹	春天华尔兹
女人帮	女人帮
一休宗纯	一休宗纯
陌生人	陌生人
英雄少年	英雄少年
灰姑娘	灰姑娘
美人计	美人计
需要浪漫	需要浪漫
暴力罗曼史	暴力罗曼史
酸酸甜甜就是我	酸酸甜甜就是我
雀圣2：自摸天后	雀圣2：自摸天后
乡村爱情圆舞曲	乡村爱情圆舞曲
我要去西藏	我要去西藏
天行者	天行者
邱胜翊	邱胜翊
流氓大亨	流氓大亨
火宅之人	火宅之人
游园惊梦	游园惊梦
玉蜻蜓	玉蜻蜓
当我唱起这首歌	当我唱起这首歌
十把穿金扇	十把穿金扇
卖汤圆	卖汤圆
仁医	仁医
给亲爱的你	给亲爱的你
兵圣	兵圣
那些女孩教我的事	那些女孩教我的事
好心分手	好心分手
向快乐出发	向快乐出发
我的美女老师	我的美女老师
还是会寂寞	还是会寂寞
Blackstar	Blackstar
离天国最近的男人	离天国最近的男人
冒牌天神	冒牌天神
含苞欲坠的每一天	含苞欲坠的每一天
Back To Black	Back To Black
澄和堇~年轻了45岁的女人~	澄和堇~年轻了45岁的女人~
黑四角	黑四角
谢谢自己够勇敢	谢谢自己够勇敢
回味	回味
指弹	指弹
Do It Like A Dude	Do It Like A Dude
学校风云	学校风云
包容	包容
虎纹月亮	虎纹月亮
阿飞正传	阿飞正传
相聚一刻	相聚一刻
有多想你就有多爱你	有多想你就有多爱你
情色	情色
绣花鞋	绣花鞋
王的女人	王的女人
当他呼唤我的时候	当他呼唤我的时候
赌博默示录	赌博默示录
闪亮的进修医生	闪亮的进修医生
倚天屠龙记	倚天屠龙记
8号巴士站站情	8号巴士站站情
我的抗战	我的抗战
假结婚	假结婚
明天你是否依然爱我	明天你是否依然爱我
女人帮·妞儿	女人帮·妞儿
虎口遐想	虎口遐想
云淡风轻	云淡风轻
爱情与灵药	爱情与灵药
爱过就好	爱过就好
范海辛	范海辛
Triangle	Triangle
夜色阑珊	夜色阑珊
便衣警官	便衣警官
不想骗自己	不想骗自己
相逢何必曾相识	相逢何必曾相识
变态假面	变态假面
钟点工们	钟点工们
唐朝好男人	唐朝好男人
加油！金先生	加油！金先生
西圣地	西圣地
真实的谎言	真实的谎言
play	play
聊斋奇女子	聊斋奇女子
云顶天很蓝	云顶天很蓝
你们我们他们	你们我们他们
GOODLUCK!!	GOODLUCK!!
约翰·康斯坦丁	约翰·康斯坦丁
习惯	习惯
天空小说	天空小说
平贵别窑	平贵别窑
亲爱的恩东啊	亲爱的恩东啊
唐朝豪放女	唐朝豪放女
我做不到不想你	我做不到不想你
隐形纪念	隐形纪念
纯情漫画	纯情漫画
也许	也许
高町奈叶	高町奈叶
寻找成龙	寻找成龙
天黑黑	天黑黑
便衣警察	便衣警察
内线	内线
夸住宅	夸住宅
农业重金属	农业重金属
杨过	杨过
花与蛇3	花与蛇3
莲花争霸	莲花争霸
深闺梦里情	深闺梦里情
柏拉图式性爱	柏拉图式性爱
岛	岛
未昏男女	未昏男女
沂蒙颂	沂蒙颂
家族荣誉	家族荣誉
虎妈猫爸	虎妈猫爸
美男记	美男记
阿育王	阿育王
健次郎	健次郎
星苹果乐园	星苹果乐园
三面夏娃	三面夏娃
乐活家庭	乐活家庭
杨门女将之女儿当自强	杨门女将之女儿当自强
冒名顶替	冒名顶替
缪斯之镜	缪斯之镜
红人制造	红人制造
凤穿牡丹	凤穿牡丹
山丘	山丘
沉静的人	沉静的人
毕业那天我们说相声	毕业那天我们说相声
我的野蛮奶奶	我的野蛮奶奶
重生门	重生门
Beautiful Light	Beautiful Light
猫咪少女	猫咪少女
小城故事	小城故事
姐妹兄弟	姐妹兄弟
不得不爱	不得不爱
毕业纪念日	毕业纪念日
爱情的房子	爱情的房子
舞动奇迹	舞动奇迹
独臂刀王	独臂刀王
双人床条约	双人床条约
宠物情人	宠物情人
天天有喜	天天有喜
演员	演员
陈世美	陈世美
天使之眼	天使之眼
阿飞的小蝴蝶	阿飞的小蝴蝶
东方红1949	东方红1949
对我而言，可爱的她	对我而言，可爱的她
浪子的心情	浪子的心情
追	追
钦差大臣	钦差大臣
冲上云霄Ⅱ	冲上云霄Ⅱ
乱世忠魂	乱世忠魂
黄石的孩子	黄石的孩子
我爱HK开心万岁	我爱HK开心万岁
万凰之王	万凰之王
好日子	好日子
守望天湖	守望天湖
九龙冰室	九龙冰室
八月一日	八月一日
孟姜女	孟姜女
野丫头	野丫头
黄昏放牛	黄昏放牛
缉毒英雄	缉毒英雄
浮城谜事	浮城谜事
潘神的迷宫	潘神的迷宫
类似爱情	类似爱情
雨后骄阳	雨后骄阳
自由之花	自由之花
爱情洗牌	爱情洗牌
四手妙弹	四手妙弹
我的少女时代	我的少女时代
我的幸福	我的幸福
汤姆·琼斯	汤姆·琼斯
last	last
杨光的爱情故事	杨光的爱情故事
依家有喜	依家有喜
阳阳	阳阳
天与地	天与地
迷失金三角	迷失金三角
男人帮	男人帮
懂了爱	懂了爱
小背篓	小背篓
天若有情Ⅱ之天长地久	天若有情Ⅱ之天长地久
意乱情迷	意乱情迷
悲情布鲁克	悲情布鲁克
亲爱的你怎么不在我身边	亲爱的你怎么不在我身边
365天	365天
红带高手	红带高手
忘情水	忘情水
电脑之家	电脑之家
洋葱	洋葱
AA制生活	AA制生活
健康歌	健康歌
约饭	约饭
彩色精灵	彩色精灵
貘良了	貘良了
devil	devil
他·她	他·她
忘了	忘了
成吉思汗	成吉思汗
红豆面包	红豆面包
野性之声	野性之声
绝望主妇	绝望主妇
海上牧云记	海上牧云记
我爱美人鱼	我爱美人鱼
逃兵	逃兵
哥们	哥们
我的祖国	我的祖国
fire	fire
迷茫的爱	迷茫的爱
夜王	夜王
浑身是胆	浑身是胆
空之境界	空之境界
家庭作业	家庭作业
说好不想你	说好不想你
Dance With My Father	Dance With My Father
问题和答案	问题和答案
刺杀肯尼迪	刺杀肯尼迪
忍着伤痛忘记你	忍着伤痛忘记你
数码兽合体战争	数码兽合体战争
萤爱	萤爱
给陌生女孩的歌	给陌生女孩的歌
快乐老家	快乐老家
公鸡打鸣，母鸡下蛋	公鸡打鸣，母鸡下蛋
绝世高手之大侠卢小鱼	绝世高手之大侠卢小鱼
邮差	邮差
外面的世界	外面的世界
水姑娘	水姑娘
金婚	金婚
慢歌	慢歌
恋人心中有一首诗	恋人心中有一首诗
诱僧	诱僧
犀利人妻	犀利人妻
恐怖禁忌之红旗袍	恐怖禁忌之红旗袍
芬芳的山谷	芬芳的山谷
笑林小子Ⅱ之新乌龙院	笑林小子Ⅱ之新乌龙院
大地	大地
所爱非人	所爱非人
爱的卡洛里	爱的卡洛里
我是太阳	我是太阳
想明白了再结婚	想明白了再结婚
真的汉子	真的汉子
义雁情鸳	义雁情鸳
伊丽莎白一世	伊丽莎白一世
岁月忽已暮	岁月忽已暮
月蚀	月蚀
出狱	出狱
战神韩信	战神韩信
北京·纽约	北京·纽约
往日情	往日情
忘忧草	忘忧草
杀手·婚礼之路	杀手·婚礼之路
蝙蝠侠归来	蝙蝠侠归来
王的男人	王的男人
用心良苦	用心良苦
星球大战：原力觉醒	星球大战：原力觉醒
last christmas	last christmas
少年康熙	少年康熙
等救火的日子	等救火的日子
喜盈门	喜盈门
踢踏踢踏	踢踏踢踏
王贵与安娜	王贵与安娜
发胶	发胶
I'm yours	I'm yours
铁拳男人	铁拳男人
再见之前	再见之前
大话捧逗	大话捧逗
金剑雕翎	金剑雕翎
我的女神	我的女神
我要成名	我要成名
整垮EX	整垮EX
魔幻手机	魔幻手机
寻人启事	寻人启事
沙普	沙普
武则天	武则天
秋之回忆：想君	秋之回忆：想君
逢场作戏	逢场作戏
顺藤而上的你	顺藤而上的你
我爱的人	我爱的人
结婚进行时	结婚进行时
终极一班4	终极一班4
较量	较量
偏偏爱上你	偏偏爱上你
黛玉笑了	黛玉笑了
煮妇神探	煮妇神探
佳期如梦	佳期如梦
爱情玩咖	爱情玩咖
玻璃假面	玻璃假面
我的左脚	我的左脚
伟大的苏珊	伟大的苏珊
so hot	so hot
飞越龙门客栈	飞越龙门客栈
移动迷宫	移动迷宫
我的老大，我的英雄	我的老大，我的英雄
小酒窝	小酒窝
天真遇到现实	天真遇到现实
迪厅孩童	迪厅孩童
慢慢来	慢慢来
父亲的草原母亲的河	父亲的草原母亲的河
地下地上	地下地上
爱在日月潭	爱在日月潭
神探狄仁杰前传	神探狄仁杰前传
宋家皇朝	宋家皇朝
愚人的国度	愚人的国度
危险智能	危险智能
命运规划局	命运规划局
跳跃大搜查线	跳跃大搜查线
街头霸王	街头霸王
分裂	分裂
微博达人	微博达人
非常绑架	非常绑架
刘海砍樵	刘海砍樵
我的燃情岁月	我的燃情岁月
嫁入豪门	嫁入豪门
白衣校花与大长腿	白衣校花与大长腿
乡村爱情2	乡村爱情2
倩女幽魂	倩女幽魂
眼泪知道	眼泪知道
菊次郎的夏天	菊次郎的夏天
王者丑生	王者丑生
巧对影联	巧对影联
秦香莲	秦香莲
小霞	小霞
continue	continue
戏梦巴黎	戏梦巴黎
风云	风云
吴道子	吴道子
罗马假日	罗马假日
一级病毒	一级病毒
半夜不要照镜子	半夜不要照镜子
玛依拉变奏曲	玛依拉变奏曲
克洛诺·哈洛温	克洛诺·哈洛温
自古英雄出少年	自古英雄出少年
东邪西毒	东邪西毒
龙咁威	龙咁威
怎样	怎样
万里长城永不倒	万里长城永不倒
怒海沉尸	怒海沉尸
明星志愿	明星志愿
少林寺传奇	少林寺传奇
夏尔·凡多姆海恩	夏尔·凡多姆海恩
BORING	BORING
荆棘花	荆棘花
苔藓	苔藓
心花路放	心花路放
花枪缘	花枪缘
火恋	火恋
鬼吹灯之精绝古城	鬼吹灯之精绝古城
青年旅社	青年旅社
红衣小女孩	红衣小女孩
局内人们	局内人们
鬼眼刑警	鬼眼刑警
夫妻那些事	夫妻那些事
引以为荣	引以为荣
致美丽的你	致美丽的你
紫荆勋章	紫荆勋章
守护甜心！	守护甜心！
同窗会	同窗会
幻影	幻影
哼唱	哼唱
上位	上位
一起去旅行	一起去旅行
后来我们都哭了	后来我们都哭了
波士顿法律	波士顿法律
爱很美	爱很美
霍元甲	霍元甲
巴厘岛的故事	巴厘岛的故事
大唐荣耀	大唐荣耀
最后一枪	最后一枪
安德的游戏	安德的游戏
自梳	自梳
那山那人那狗	那山那人那狗
非洲梦	非洲梦
罗密欧与朱丽叶	罗密欧与朱丽叶
记得我们爱过	记得我们爱过
必要的杀戮	必要的杀戮
玫瑰江湖	玫瑰江湖
离岛特警	离岛特警
我就是这样	我就是这样
飞花如蝶	飞花如蝶
一公升的眼泪	一公升的眼泪
唯爱	唯爱
少年杨家将	少年杨家将
自然城市	自然城市
ACE	ACE
别了，温哥华	别了，温哥华
极道鲜师	极道鲜师
天庭护经队	天庭护经队
草上飞	草上飞
雪花秘扇	雪花秘扇
sexy back	sexy back
佐罗的面具	佐罗的面具
喜马拉雅	喜马拉雅
狠不下心	狠不下心
南拳北腿	南拳北腿
神枪	神枪
珍珠港	珍珠港
痛彻心扉	痛彻心扉
一个百万富翁的初恋	一个百万富翁的初恋
婚后三十年	婚后三十年
雪域雄鹰	雪域雄鹰
晚秋	晚秋
心灵传输者	心灵传输者
这片海	这片海
苏菲的抉择	苏菲的抉择
转身过后	转身过后
德吉的诉讼	德吉的诉讼
我为宫狂	我为宫狂
伊豆的舞女	伊豆的舞女
战鼓	战鼓
A.I.N.Y.	A.I.N.Y.
王熙凤	王熙凤
错乱的一代	错乱的一代
阳光起航	阳光起航
幕后大老爷	幕后大老爷
田庄英雄	田庄英雄
灵灵	灵灵
桔梗	桔梗
阿里山风云	阿里山风云
刘金定	刘金定
20岁	20岁
美丽密令	美丽密令
伴我闯天涯	伴我闯天涯
换换爱	换换爱
酒后的心声	酒后的心声
爱与哀愁	爱与哀愁
济公之歌	济公之歌
梅岭星火	梅岭星火
星语星愿	星语星愿
Strong Baby	Strong Baby
住之江亚香	住之江亚香
极速天使	极速天使
笔记	笔记
海阔天空	海阔天空
任弼时	任弼时
少数意见	少数意见
为你痴情	为你痴情
You Think	You Think
法外英雄	法外英雄
釜山行	釜山行
幸福的抉择	幸福的抉择
余罪	余罪
啊！摇篮	啊！摇篮
重返17岁	重返17岁
水男孩	水男孩
偶像大师	偶像大师
胡椒面	胡椒面
近肖古王	近肖古王
西关大少	西关大少
儿歌	儿歌
爱之链	爱之链
老爸的筒子楼	老爸的筒子楼
快乐星期天	快乐星期天
好男好女	好男好女
分秒必争	分秒必争
战争目光	战争目光
迷失课后	迷失课后
在我身边	在我身边
在那东山顶上	在那东山顶上
道林·格雷	道林·格雷
亲亲小爸	亲亲小爸
解脱	解脱
爸爸父亲爹	爸爸父亲爹
老虎出更2	老虎出更2
奇女子	奇女子
空中飞人	空中飞人
火线追凶	火线追凶
随时都在	随时都在
青春烈火	青春烈火
篱笆·女人和狗	篱笆·女人和狗
风，再起时	风，再起时
国家命运	国家命运
五口之家	五口之家
大阿哥溥俊	大阿哥溥俊
上条当麻	上条当麻
离家出走	离家出走
溏心风暴	溏心风暴
hello	hello
伍子胥	伍子胥
爱欲残骸	爱欲残骸
富翁的诞生	富翁的诞生
非我不行	非我不行
爱神	爱神
围城	围城
早乙女玄马	早乙女玄马
福气又安康	福气又安康
21 Questions	21 Questions
他来自江湖	他来自江湖
女大十九变	女大十九变
灰色地带	灰色地带
教父2	教父2
云南	云南
我在1949等你	我在1949等你
夺爱之冬	夺爱之冬
前任攻略	前任攻略
春逝	春逝
宿敌	宿敌
烈火中永生	烈火中永生
正义青春	正义青春
希望	希望
后窗	后窗
恋恋女人香	恋恋女人香
女王范	女王范
弯弯的月亮	弯弯的月亮
神奇女侠	神奇女侠
白云深处	白云深处
回归	回归
忠烈杨家将	忠烈杨家将
枯叶车站	枯叶车站
生命因你而美丽	生命因你而美丽
见习×爱	见习×爱
罪域	罪域
magic	magic
柳荫记	柳荫记
狮子座	狮子座
策马啸西风	策马啸西风
try	try
天下无贼	天下无贼
贞观之治	贞观之治
香港大夜总会	香港大夜总会
开往名古屋的末班列车	开往名古屋的末班列车
笑林小子	笑林小子
i need a doctor	i need a doctor
口香糖	口香糖
赤裸裸	赤裸裸
尘埃落定	尘埃落定
雨爱	雨爱
双面娇	双面娇
情哥哥去南方	情哥哥去南方
时间的歌	时间的歌
螺丝小姐要出嫁	螺丝小姐要出嫁
忘了你忘了我	忘了你忘了我
死神少女	死神少女
他来了，请闭眼	他来了，请闭眼
回首又见他	回首又见他
我和老妈一起嫁	我和老妈一起嫁
是不是梦	是不是梦
变形金刚4：绝迹重生	变形金刚4：绝迹重生
极速青春	极速青春
李叔同	李叔同
爱的妇产科	爱的妇产科
杀死比尔	杀死比尔
一夜惊喜	一夜惊喜
家族的形式	家族的形式
婚姻的敌人	婚姻的敌人
翻转坏未来	翻转坏未来
爱的躯壳	爱的躯壳
非洲女王号	非洲女王号
临时演员	临时演员
大地春雷	大地春雷
各就各位	各就各位
负君千行泪	负君千行泪
为你而来	为你而来
狼与美女	狼与美女
我不是潘金莲	我不是潘金莲
蜘蛛侠	蜘蛛侠
律政俏佳人	律政俏佳人
回忆	回忆
时尚王	时尚王
学警出更	学警出更
十三号凶宅	十三号凶宅
我的儿子是天才	我的儿子是天才
不差钱	不差钱
日出城市	日出城市
叫我第一名	叫我第一名
阖第光临	阖第光临
香味	香味
龙年	龙年
教父	教父
老婆大人	老婆大人
Moment 4 Life	Moment 4 Life
奈亚子	奈亚子
六号出口	六号出口
琴吹䌷	琴吹䌷
明天过后	明天过后
红豆	红豆
我的内心戏	我的内心戏
反省	反省
鸟人	鸟人
走过长安街	走过长安街
爱上你	爱上你
征陆智己	征陆智己
危情3日	危情3日
米内特	米内特
超人高校	超人高校
智慧家庭救助队	智慧家庭救助队
名侦探柯南	名侦探柯南
人生是美丽的	人生是美丽的
暗示	暗示
冷静与热情之间	冷静与热情之间
墨纸	墨纸
没你的周末	没你的周末
薛仁贵	薛仁贵
让我们荡起双桨	让我们荡起双桨
鬼打鬼	鬼打鬼
囚禁	囚禁
baby	baby
周恩来在重庆	周恩来在重庆
春蚕	春蚕
还我河山	还我河山
芝麻开门	芝麻开门
金燕子	金燕子
谋杀快乐	谋杀快乐
桃花朵朵开	桃花朵朵开
幸福保卫战	幸福保卫战
失踪的宝贝	失踪的宝贝
丁香花	丁香花
喜临门家具股份有限公司	喜临门家具股份有限公司
菜鸟谈恋爱	菜鸟谈恋爱
智齿	智齿
射雕英雄传之九阴真经	射雕英雄传之九阴真经
中华小当家	中华小当家
李雷和韩梅梅	李雷和韩梅梅
哥哥	哥哥
比海更深	比海更深
轮流传	轮流传
功夫小子	功夫小子
心花放	心花放
夜·上海	夜·上海
玛丽娜	玛丽娜
佐藤美和子	佐藤美和子
既然青春留不住	既然青春留不住
茧	茧
狱门岛	狱门岛
拳赌双至尊	拳赌双至尊
变形金刚2	变形金刚2
变形金刚3	变形金刚3
坐上火车去拉萨	坐上火车去拉萨
云水谣	云水谣
对不起爱上你	对不起爱上你
歌女红牡丹	歌女红牡丹
宝莲灯	宝莲灯
好奇的乔治	好奇的乔治
神南署安积班	神南署安积班
我想和你好好的	我想和你好好的
我们发财了	我们发财了
奕想天开	奕想天开
男人的资格	男人的资格
逆鳞	逆鳞
遇见	遇见
好好先生	好好先生
濠江有情	濠江有情
病毒	病毒
五味俱全	五味俱全
失业情歌	失业情歌
掀起你的盖头来	掀起你的盖头来
你说你还爱我	你说你还爱我
女人30情定水舞间	女人30情定水舞间
福尔摩斯	福尔摩斯
春水流	春水流
我叫郝聪明	我叫郝聪明
狼烟北平	狼烟北平
儿女情长	儿女情长
夏雨来	夏雨来
她有你要的	她有你要的
光荣	光荣
人龙传说	人龙传说
仙女湖	仙女湖
大明王朝1566嘉靖与海瑞	大明王朝1566嘉靖与海瑞
一个人回家	一个人回家
尖子攻略	尖子攻略
芳香之城	芳香之城
法外风云	法外风云
重案实录纸醉金迷	重案实录纸醉金迷
谁来伺候妈	谁来伺候妈
坂井和奏	坂井和奏
网球王子舞台剧	网球王子舞台剧
大爱晚成	大爱晚成
雕刻结局	雕刻结局
连环局	连环局
深夜烘焙坊	深夜烘焙坊
九头案	九头案
街角的小王子	街角的小王子
喜事连连：剩男相亲记	喜事连连：剩男相亲记
转身说爱你	转身说爱你
三日月	三日月
蜜蜜宣言	蜜蜜宣言
朋友的酒	朋友的酒
我的爱在身边	我的爱在身边
武术之少年行	武术之少年行
土地公土地婆	土地公土地婆
开拓者	开拓者
换子成龙	换子成龙
疯狂的钱	疯狂的钱
卖拐	卖拐
屋塔房王世子	屋塔房王世子
小宝和老财	小宝和老财
享受寂寞	享受寂寞
我是传奇	我是传奇
秋之回忆	秋之回忆
天堂电影院	天堂电影院
天仙配	天仙配
同志亦凡人	同志亦凡人
听见下雨的声音	听见下雨的声音
喊月亮	喊月亮
明星的恋人	明星的恋人
律政新人王Ⅱ	律政新人王Ⅱ
梦想家	梦想家
创圣的大天使	创圣的大天使
高山青	高山青
好欺负吗	好欺负吗
忘记他	忘记他
心动列车	心动列车
不是冤家不聚头	不是冤家不聚头
爱你，万缕千丝	爱你，万缕千丝
we belong together	we belong together
袖手旁观	袖手旁观
棉花糖	棉花糖
超能快递侠	超能快递侠
小时候	小时候
美国甜心	美国甜心
笔仙Ⅱ	笔仙Ⅱ
逆世界	逆世界
葵德川三代	葵德川三代
双响炮	双响炮
寂静的天空	寂静的天空
好奇害死猫	好奇害死猫
乱世情殇	乱世情殇
火柴天堂	火柴天堂
小时代	小时代
母亲三十岁	母亲三十岁
密使	密使
山贼	山贼
进城1949	进城1949
朝鲜神枪手	朝鲜神枪手
寓言	寓言
水浒少年	水浒少年
那么骄傲	那么骄傲
爱人同志	爱人同志
裸婚时代	裸婚时代
密会	密会
家门的荣光	家门的荣光
安详之兽	安详之兽
香樟	香樟
说谎	说谎
明日赞歌	明日赞歌
美丽时光	美丽时光
廉政风暴	廉政风暴
蜜蜂的秘密生活	蜜蜂的秘密生活
少年王	少年王
霍比特人	霍比特人
十二生肖传奇	十二生肖传奇
谢谢你给的温柔	谢谢你给的温柔
学不会	学不会
妈妈我拿什么爱你	妈妈我拿什么爱你
当我们一起走过	当我们一起走过
无声的告别	无声的告别
西部世界	西部世界
共妻共夫	共妻共夫
所谓如昀	所谓如昀
春风十里不如你	春风十里不如你
相知香玉	相知香玉
真情满天下	真情满天下
福根进城	福根进城
维纳斯旅馆	维纳斯旅馆
虎度门	虎度门
猫和老鼠	猫和老鼠
捉贼记	捉贼记
爱回来	爱回来
阴阳错	阴阳错
沉默的证人	沉默的证人
one better	one better
盛装舞步爱作战	盛装舞步爱作战
致命密函	致命密函
说了八百遍800	说了八百遍800
逃亡者PLAN B	逃亡者PLAN B
世界番付	世界番付
爱的是你	爱的是你
多大事啊	多大事啊
乱世三义	乱世三义
韦礼安	韦礼安
同一屋檐下	同一屋檐下
侠骨丹心	侠骨丹心
爱归来	爱归来
大雪无痕	大雪无痕
信义	信义
没有家园的灵魂	没有家园的灵魂
香港制造	香港制造
快乐星球Ⅱ	快乐星球Ⅱ
花瓣	花瓣
打起手鼓唱起歌	打起手鼓唱起歌
野蛮奶奶大战戈师奶	野蛮奶奶大战戈师奶
龙腾四海	龙腾四海
守婚如玉	守婚如玉
周芷若	周芷若
百科全说	百科全说
征服	征服
对手	对手
盘夫索夫	盘夫索夫
怕你看见我悲伤	怕你看见我悲伤
托尼托尼·乔巴	托尼托尼·乔巴
急症室的故事	急症室的故事
五感图	五感图
你笑了	你笑了
冬天里的一把火	冬天里的一把火
京城四少	京城四少
猛兽列车	猛兽列车
Game Over	Game Over
不想睡	不想睡
张小凡的萌食店	张小凡的萌食店
毛泽东和他的儿子	毛泽东和他的儿子
新恋爱时代	新恋爱时代
爱你爱到死	爱你爱到死
大姐	大姐
掌上明珠	掌上明珠
黎明之前	黎明之前
天堂边缘	天堂边缘
杯酒人生	杯酒人生
阳光小美女	阳光小美女
奇异家庭	奇异家庭
幸福爱人	幸福爱人
仙儿	仙儿
摩登新人类	摩登新人类
月亮星星太阳	月亮星星太阳
亲爱的那不是爱情	亲爱的那不是爱情
大染坊	大染坊
家家有本难念的经	家家有本难念的经
深圳之恋	深圳之恋
暗算	暗算
苗岭风雷	苗岭风雷
我独自在风雨中	我独自在风雨中
大闹广昌隆	大闹广昌隆
冰清玉洁	冰清玉洁
无家可归的孩子蕾米	无家可归的孩子蕾米
果宝特攻	果宝特攻
大话李白	大话李白
音乐孩子王	音乐孩子王
哈姆太郎	哈姆太郎
一一之吻	一一之吻
情愿离开	情愿离开
花心	花心
蛇形刁手	蛇形刁手
致我们终将到来的爱情	致我们终将到来的爱情
榴莲飘飘	榴莲飘飘
爱情路	爱情路
杀人漫画	杀人漫画
老男孩	老男孩
集结号	集结号
Invisible	Invisible
宫本丽	宫本丽
我们能不能	我们能不能
天官赐福	天官赐福
山里娘们山里汉	山里娘们山里汉
名校	名校
长空	长空
爱无止尽	爱无止尽
春风物语	春风物语
警戒先锋	警戒先锋
武松	武松
家园	家园
拳来拳往	拳来拳往
大奥	大奥
大逃杀2：镇魂歌	大逃杀2：镇魂歌
贤妻	贤妻
醉侠苏乞儿	醉侠苏乞儿
唐宫美人天下	唐宫美人天下
兵心	兵心
野兽男孩	野兽男孩
土楼	土楼
世间情	世间情
新娱乐在线	新娱乐在线
影子猎人	影子猎人
ONE SHOT	ONE SHOT
上海人在东京	上海人在东京
学着	学着
最后一次温柔	最后一次温柔
Don't say	Don't say
旗舰	旗舰
战舰波将金号	战舰波将金号
梦比优斯·奥特曼	梦比优斯·奥特曼
虎豹小霸王	虎豹小霸王
我不是你最好的归宿	我不是你最好的归宿
工薪族楚汉志	工薪族楚汉志
人间色相	人间色相
天堂的门口	天堂的门口
一步之遥	一步之遥
将军日记	将军日记
生命花	生命花
我这一辈子	我这一辈子
风声传奇	风声传奇
Doctor异乡人	Doctor异乡人
希望之鸽	希望之鸽
归天图	归天图
致命的承诺	致命的承诺
雨中的树	雨中的树
封神传奇	封神传奇
一个人遗憾	一个人遗憾
夹板气	夹板气
不可撤销	不可撤销
那又怎样	那又怎样
穆罕默德·阿里	穆罕默德·阿里
等候董建华发落	等候董建华发落
婚纱	婚纱
王阳明	王阳明
上班这党事	上班这党事
时尚女编辑	时尚女编辑
白影	白影
病院惊魂	病院惊魂
只有你是我无法离开的人	只有你是我无法离开的人
lucky	lucky
外婆的笑	外婆的笑
远去的飞鹰	远去的飞鹰
小铃铛	小铃铛
谁说我不在乎	谁说我不在乎
我心飞翔	我心飞翔
恋爱格局	恋爱格局
风雨雕花楼	风雨雕花楼
夏日的么么茶	夏日的么么茶
庸才	庸才
来自温州	来自温州
三眼神童	三眼神童
拥抱黄金飞翔	拥抱黄金飞翔
亮相	亮相
站直啰！别趴下	站直啰！别趴下
摇滚新乐团	摇滚新乐团
父亲写的散文诗	父亲写的散文诗
雪天使	雪天使
樱兰高校男公关部	樱兰高校男公关部
007之黄金眼	007之黄金眼
让你快乐让你瘦	让你快乐让你瘦
香蕉新乐园	香蕉新乐园
翻滚吧！阿信	翻滚吧！阿信
不是过错的错过	不是过错的错过
野狐梁的女人	野狐梁的女人
沙漏	沙漏
亲爱的你	亲爱的你
天上人间	天上人间
监狱风云	监狱风云
不要犹豫	不要犹豫
死性不改	死性不改
婚姻时差	婚姻时差
敢死队2	敢死队2
浪漫满屋2	浪漫满屋2
寻情记	寻情记
暗黑者2	暗黑者2
仁者无敌	仁者无敌
梅花烙	梅花烙
谍影重重	谍影重重
布衣神相	布衣神相
亲爱的阿基米德	亲爱的阿基米德
最重要的决定	最重要的决定
蹉跎岁月	蹉跎岁月
开始	开始
阿郎的故事	阿郎的故事
大师	大师
济公新传	济公新传
我怀念的	我怀念的
义气千秋	义气千秋
凤镜夜	凤镜夜
婷婷	婷婷
金大班	金大班
律政佳人2	律政佳人2
走近科学	走近科学
永远的三丁目的夕阳	永远的三丁目的夕阳
她说	她说
男装的丽人~川岛芳子的生涯~	男装的丽人~川岛芳子的生涯~
再见警察	再见警察
七个朋友	七个朋友
雪狼谷	雪狼谷
民心难违	民心难违
少林十八铜人	少林十八铜人
神秘河	神秘河
你是我生命	你是我生命
爱情公寓4	爱情公寓4
画框女人	画框女人
八两金	八两金
一个人的武林	一个人的武林
需要浪漫3	需要浪漫3
走天涯	走天涯
雨瞳	雨瞳
美少女特攻队	美少女特攻队
雪花神剑	雪花神剑
幸运符	幸运符
你好乔安	你好乔安
天龙传奇	天龙传奇
小鱼	小鱼
光阴的故事	光阴的故事
好胆你就来	好胆你就来
八星抱喜	八星抱喜
容闳	容闳
反击王	反击王
关正杰	关正杰
爱的曝光	爱的曝光
满街都是寂寞的朋友	满街都是寂寞的朋友
大王之梦	大王之梦
点金者	点金者
金刚	金刚
我们结婚吧	我们结婚吧
别哭了宝贝	别哭了宝贝
锦绣前程	锦绣前程
美人制造	美人制造
超级世家	超级世家
小提琴家	小提琴家
又见谷峰	又见谷峰
硝烟背后的战争	硝烟背后的战争
我是公务员	我是公务员
楚留香新传	楚留香新传
平步倾云	平步倾云
加油爱人	加油爱人
浔阳楼	浔阳楼
夏日示爱	夏日示爱
人到中年	人到中年
文成公主	文成公主
状元未了情	状元未了情
金牌冰人	金牌冰人
青天衙门	青天衙门
香港奇案之强奸	香港奇案之强奸
my love	my love
情浓大地	情浓大地
小薇	小薇
天生快活人	天生快活人
斯巴达克斯	斯巴达克斯
MR.恋人	MR.恋人
修炼爱情	修炼爱情
2012	2012
预告犯	预告犯
西游记之大闹天宫	西游记之大闹天宫
时の流れに身をまかせ	时の流れに身をまかせ
致，第三者	致，第三者
报答祖国	报答祖国
火线三兄弟	火线三兄弟
云图	云图
细路祥	细路祥
八兄弟	八兄弟
mockingbird	mockingbird
四十九日·祭	四十九日·祭
给野兽献花	给野兽献花
つぐない	つぐない
因为有爱	因为有爱
围剿	围剿
情来运转	情来运转
亲爱的！好久不见	亲爱的！好久不见
不羁夜	不羁夜
绝代双雄	绝代双雄
三哭殿	三哭殿
特种部队：眼镜蛇的崛起	特种部队：眼镜蛇的崛起
公主嫁到	公主嫁到
我一定要成功	我一定要成功
情系北大荒	情系北大荒
走过路过别错过	走过路过别错过
看见鬼的刑警处容	看见鬼的刑警处容
少年时代	少年时代
妖怪大战争	妖怪大战争
爱在苍茫大地	爱在苍茫大地
我的太阳	我的太阳
杀尽豺狼	杀尽豺狼
冰血暴第二季	冰血暴第二季
冒险游戏	冒险游戏
青城之恋	青城之恋
贻笑大方	贻笑大方
好歹一家人	好歹一家人
火星情报局	火星情报局
学评戏	学评戏
庭院深深	庭院深深
骚人	骚人
遗憾	遗憾
荒江女侠	荒江女侠
龙须沟	龙须沟
爱那么重	爱那么重
爱在雨季	爱在雨季
于无声处	于无声处
太平洋的风	太平洋的风
because of you	because of you
自由	自由
世界第一麦方	世界第一麦方
孤儿泪	孤儿泪
花燃	花燃
灿烂的遗产	灿烂的遗产
忧伤的旋律	忧伤的旋律
远方的客人请你留下来	远方的客人请你留下来
会飞的贼	会飞的贼
我爱你中国	我爱你中国
漂洋过海来看你	漂洋过海来看你
我不想说	我不想说
京城十三钗	京城十三钗
最后征战	最后征战
害虫	害虫
寂静岭	寂静岭
爱要怎么说出口	爱要怎么说出口
皇家师姐	皇家师姐
卡波特	卡波特
爱忧伤	爱忧伤
喜从天降	喜从天降
七侠五义	七侠五义
纯真岁月	纯真岁月
真情三人行	真情三人行
人间正道	人间正道
妈妈我爱你	妈妈我爱你
大哥	大哥
狼侠	狼侠
听风者	听风者
识法代言人	识法代言人
爱是一个美丽的错	爱是一个美丽的错
南国	南国
舍不得你	舍不得你
永不退缩	永不退缩
杨宗纬	杨宗纬
只记今朝笑	只记今朝笑
弱水	弱水
大女人	大女人
狼王子	狼王子
暹罗之恋	暹罗之恋
跳出我天地	跳出我天地
鬼铃	鬼铃
黄飞鸿与十三姨	黄飞鸿与十三姨
Can You Celebrate	Can You Celebrate
柳梦梅	柳梦梅
巍巍昆仑	巍巍昆仑
怎么浪漫都可以	怎么浪漫都可以
热血高校	热血高校
全民超人汉考克	全民超人汉考克
温暖的尸体	温暖的尸体
我的美丽与哀愁	我的美丽与哀愁
林黛玉	林黛玉
爱就是咖喱	爱就是咖喱
i believe i can fly	i believe i can fly
自梳女	自梳女
她恨我	她恨我
老爸老妈	老爸老妈
史密斯夫妇	史密斯夫妇
Warrior	Warrior
幸福绽放	幸福绽放
名流	名流
我深深爱着你啊	我深深爱着你啊
散了吧	散了吧
下个入口	下个入口
够爱	够爱
美少女战士	美少女战士
错恨	错恨
风早翔太	风早翔太
战雷	战雷
原来是美男啊	原来是美男啊
耳分高下	耳分高下
我想见上帝	我想见上帝
天伦乐	天伦乐
冷箭	冷箭
白衣天使	白衣天使
归来的时效警察	归来的时效警察
黄师傅走天涯	黄师傅走天涯
谁让你是优秀	谁让你是优秀
一千遍我爱你	一千遍我爱你
开心女鬼	开心女鬼
我爱猪八戒	我爱猪八戒
你好吗。我很好	你好吗。我很好
借用一下你的爱	借用一下你的爱
WHITE BREATH	WHITE BREATH
无法阻挡的highkick	无法阻挡的highkick
一笑倾城	一笑倾城
厕所女神	厕所女神
黄金十年	黄金十年
丈母娘来了	丈母娘来了
无间道1	无间道1
醉画仙	醉画仙
呆佬贺寿	呆佬贺寿
金门新娘	金门新娘
娜乌西卡	娜乌西卡
唐山大兄	唐山大兄
绯闻女孩	绯闻女孩
连环套	连环套
就像今天一样	就像今天一样
唇膏	唇膏
罗马浴场	罗马浴场
楚汉争雄	楚汉争雄
恶老板	恶老板
无人知晓	无人知晓
聊宅	聊宅
宫永咲	宫永咲
八神太一	八神太一
欲海情魔	欲海情魔
老爸拼吧	老爸拼吧
黑白格子裙	黑白格子裙
威廉王子	威廉王子
八月桂花香	八月桂花香
重庆美女	重庆美女
好好长大的女儿荷娜	好好长大的女儿荷娜
江湖兄弟	江湖兄弟
恋人絮语	恋人絮语
愿我能	愿我能
半路父子	半路父子
天啸	天啸
今晚80后脱口秀	今晚80后脱口秀
就想赖着你	就想赖着你
没完没了	没完没了
枪械师	枪械师
北城	北城
星星月亮	星星月亮
夏伤	夏伤
超越梦想	超越梦想
买房夫妻	买房夫妻
水野亚美	水野亚美
相反的我	相反的我
走马灯株式会社	走马灯株式会社
达·芬奇密码	达·芬奇密码
乘风破浪	乘风破浪
紫玉金砂	紫玉金砂
男媒婆	男媒婆
Red Velvet	Red Velvet
土浦梁太郎	土浦梁太郎
灾难大电影	灾难大电影
黎明之战	黎明之战
正德演义	正德演义
神通乡巴佬	神通乡巴佬
非常青春期	非常青春期
偶像先生	偶像先生
我再也不要对你那么好	我再也不要对你那么好
往日情怀	往日情怀
惩戒者	惩戒者
婉君	婉君
魔鬼代言人	魔鬼代言人
明明知道相思苦	明明知道相思苦
CID	CID
圆圆的故事	圆圆的故事
7号差馆	7号差馆
紫檀王	紫檀王
生死线	生死线
沙僧日记	沙僧日记
万卷楼	万卷楼
天堂牧场	天堂牧场
毛泽东	毛泽东
木兰从军	木兰从军
铁臂阿童木	铁臂阿童木
一生一世合家欢	一生一世合家欢
欢迎来我家	欢迎来我家
发誓	发誓
一千零一个愿望	一千零一个愿望
米脂婆姨	米脂婆姨
地狱老师	地狱老师
刘元汉	刘元汉
爱无罪	爱无罪
一吻定情～Love in TOKYO	一吻定情～Love in TOKYO
新上门女婿	新上门女婿
八一南昌起义	八一南昌起义
illusion	illusion
不只是朋友	不只是朋友
马路天使	马路天使
爱情攻略	爱情攻略
那时候的我	那时候的我
原乡人	原乡人
等我，再见	等我，再见
请以你的名字呼唤我	请以你的名字呼唤我
楚留香	楚留香
王佐断臂	王佐断臂
绅士	绅士
回声	回声
舍不得他	舍不得他
better me	better me
吸血鬼检察官	吸血鬼检察官
鬼镇	鬼镇
再见，老婆	再见，老婆
法网伊人	法网伊人
热情的沙漠	热情的沙漠
橘子红了	橘子红了
雪珂	雪珂
美国狙击手	美国狙击手
超级巨声	超级巨声
花样女子	花样女子
竹林深处	竹林深处
川岛芳子	川岛芳子
极道鲜师3	极道鲜师3
极道鲜师2	极道鲜师2
几度夕阳红	几度夕阳红
娘道	娘道
狄青	狄青
流星旅行车	流星旅行车
花信	花信
在人间	在人间
盖世枭雄	盖世枭雄
叶挺将军	叶挺将军
幸福终点站	幸福终点站
龙卷风	龙卷风
终身美丽	终身美丽
鉴识英雄	鉴识英雄
爱与罪	爱与罪
聊斋三	聊斋三
僵尸道长Ⅱ	僵尸道长Ⅱ
极度寒冷	极度寒冷
我的舅舅	我的舅舅
小店春早	小店春早
小菊的春天	小菊的春天
双面女间谍	双面女间谍
新变色龙	新变色龙
东方不败风云再起	东方不败风云再起
远山的红叶	远山的红叶
上海上海	上海上海
校园蓝调	校园蓝调
大爆炸宇宙论	大爆炸宇宙论
过期香水	过期香水
汾河湾	汾河湾
我曾有梦	我曾有梦
爱的抱抱	爱的抱抱
凤在江湖	凤在江湖
未来不是梦	未来不是梦
夜幕下的哈尔滨	夜幕下的哈尔滨
梦言	梦言
red	red
古剑奇谭	古剑奇谭
深海寻人	深海寻人
机动战士Z高达	机动战士Z高达
锥子	锥子
女人花似梦	女人花似梦
血刃	血刃
花美男拉面馆	花美男拉面馆
EVE	EVE
还珠格格之风儿阵阵吹	还珠格格之风儿阵阵吹
周恩来的四个昼夜	周恩来的四个昼夜
穆柯寨	穆柯寨
青少年法庭	青少年法庭
尖峰时刻	尖峰时刻
凤阁恩仇未了情	凤阁恩仇未了情
喜乐年华	喜乐年华
哎呀	哎呀
爱与慈悲	爱与慈悲
绿色椅子	绿色椅子
杜拉拉	杜拉拉
十全九美	十全九美
在世界中心	在世界中心
名门	名门
新的心跳	新的心跳
响聊聊职场	响聊聊职场
魂断蓝桥	魂断蓝桥
一把存忠剑	一把存忠剑
兄弟	兄弟
小手拉大手	小手拉大手
告密者	告密者
寄生灵	寄生灵
保庇	保庇
超级战舰	超级战舰
性喜剧	性喜剧
你是我的花朵	你是我的花朵
青春荷尔蒙	青春荷尔蒙
红孩儿	红孩儿
东京！	东京！
代号十三钗	代号十三钗
像雾像雨又像风	像雾像雨又像风
女人街	女人街
Hush	Hush
一生中最爱的人	一生中最爱的人
Ringa Linga	Ringa Linga
搭错车	搭错车
CODE BLUE	CODE BLUE
隋唐英雄传	隋唐英雄传
马背上的玫瑰	马背上的玫瑰
长路漫漫伴你闯	长路漫漫伴你闯
新红楼梦	新红楼梦
中国骑兵	中国骑兵
柳堡的故事	柳堡的故事
鹤啸九天	鹤啸九天
为寻花而来	为寻花而来
405谋杀案	405谋杀案
双叉路口	双叉路口
如锦	如锦
爱情倒后镜	爱情倒后镜
临别狂想曲	临别狂想曲
盖世孖宝	盖世孖宝
双旗镇刀客	双旗镇刀客
乱世三美人	乱世三美人
特朗勃	特朗勃
不想回家的女人	不想回家的女人
火花	火花
快乐女声	快乐女声
邻居	邻居
杰·富力士	杰·富力士
道士下山	道士下山
送水工	送水工
I yah	I yah
东边日出西边雨	东边日出西边雨
纽约客@上海	纽约客@上海
异种	异种
岁月匆匆	岁月匆匆
七月与安生	七月与安生
双城变奏	双城变奏
天地人	天地人
江竹筠	江竹筠
最完美的离婚	最完美的离婚
第一诫	第一诫
007：大破量子危机	007：大破量子危机
金子轻松出来吧	金子轻松出来吧
work	work
毁灭	毁灭
天使的诱惑	天使的诱惑
神奇四侠2015	神奇四侠2015
小宇	小宇
不为谁而作的歌	不为谁而作的歌
荒岛余生	荒岛余生
感情线上	感情线上
打狗棍	打狗棍
蓝天使	蓝天使
Fire and Rain	Fire and Rain
走进走出	走进走出
heartless	heartless
断背山	断背山
DESIRE -情热-	DESIRE -情热-
Fing头K王之王	Fing头K王之王
勇士之城	勇士之城
公主的诱惑	公主的诱惑
谁在意我流下的泪	谁在意我流下的泪
你真美丽	你真美丽
It's a beautiful day	It's a beautiful day
公主回来了	公主回来了
万物生	万物生
机动战士高达00	机动战士高达00
名剑	名剑
rewind	rewind
当婆婆遇上妈之欢喜冤家	当婆婆遇上妈之欢喜冤家
菈菈·萨塔琳·戴比路克	菈菈·萨塔琳·戴比路克
婚前试爱	婚前试爱
说书人	说书人
我最爱的人	我最爱的人
午夜牛郎	午夜牛郎
少共国际师	少共国际师
校花驾到之极品校花	校花驾到之极品校花
3D肉蒲团之极乐宝鉴	3D肉蒲团之极乐宝鉴
幸福摩天轮	幸福摩天轮
Dreams Come True	Dreams Come True
爱情陷阱	爱情陷阱
梦幻情侣	梦幻情侣
靠近	靠近
黄巾骑兵队	黄巾骑兵队
豪门本色	豪门本色
阿笠博士	阿笠博士
李卫当官	李卫当官
说时依旧	说时依旧
媳妇是怎样炼成的	媳妇是怎样炼成的
美女如云	美女如云
香瓜七兄弟	香瓜七兄弟
幸福街第3号出口	幸福街第3号出口
射雕英雄传之南帝北丐	射雕英雄传之南帝北丐
检察官公主	检察官公主
love me boy	love me boy
玛格丽特的春天	玛格丽特的春天
冒险爱情	冒险爱情
When I Was Your Man	When I Was Your Man
有话好好说	有话好好说
冬春的日子	冬春的日子
同伊	同伊
惊天战神	惊天战神
十月围城	十月围城
龙非龙凤非凤	龙非龙凤非凤
全是爱	全是爱
别再犹豫	别再犹豫
年轻的一代	年轻的一代
跟着你到天边	跟着你到天边
电影版	电影版
闪闪的红星	闪闪的红星
一生一世爱一回	一生一世爱一回
钢铁侠2	钢铁侠2
水月洞天	水月洞天
放手去爱	放手去爱
不必在乎我是谁	不必在乎我是谁
牡丹江	牡丹江
最炫民族风	最炫民族风
武十郎	武十郎
超级减肥王	超级减肥王
眼泪	眼泪
Control	Control
早安台北	早安台北
女蛹	女蛹
情义无价	情义无价
悬浮记忆	悬浮记忆
真情告别	真情告别
THE K2	THE K2
面试	面试
想爱都难	想爱都难
思慕的人	思慕的人
超级名模	超级名模
寒战2	寒战2
跑吧孩子	跑吧孩子
雪人	雪人
楽园project	楽园project
老蔫完婚	老蔫完婚
罗曼蒂克消亡史	罗曼蒂克消亡史
飘帅	飘帅
血色湘西	血色湘西
天梯	天梯
金粉世家	金粉世家
中国梦想秀	中国梦想秀
做人别太CNN	做人别太CNN
难民	难民
猫女	猫女
amaranth	amaranth
下一个未来	下一个未来
少年包青天Ⅲ之天芒传奇	少年包青天Ⅲ之天芒传奇
禁忌游戏之迷藏	禁忌游戏之迷藏
解语花	解语花
天鹅绒金矿	天鹅绒金矿
爱情十二元素	爱情十二元素
面包，爱情和梦想	面包，爱情和梦想
双面伊人	双面伊人
吴仁宝	吴仁宝
一个样	一个样
七彩棒棒堂	七彩棒棒堂
背靠背脸对脸	背靠背脸对脸
塞外奇侠	塞外奇侠
巨浪	巨浪
江山无限	江山无限
还珠格格3之天上人间	还珠格格3之天上人间
判我有罪	判我有罪
在这个国家生活下去	在这个国家生活下去
遇见王沥川	遇见王沥川
突然好想你	突然好想你
洪湖水	洪湖水
魔法爱情	魔法爱情
Sketch	Sketch
天使情人	天使情人
4 in love	4 in love
热浪	热浪
花言巧语	花言巧语
雨与梦的背后	雨与梦的背后
紧急审讯室	紧急审讯室
玩偶特工	玩偶特工
大学生士兵的故事	大学生士兵的故事
童话二分之一	童话二分之一
言峰绮礼	言峰绮礼
结婚十年	结婚十年
这个世界	这个世界
龙文	龙文
把根留住	把根留住
雪花女神龙	雪花女神龙
丘比特的圈套	丘比特的圈套
我祈祷	我祈祷
欢乐饭米粒儿	欢乐饭米粒儿
铁核桃	铁核桃
微笑在我心	微笑在我心
昼颜	昼颜
Bo Peep Bo Peep	Bo Peep Bo Peep
陀枪师姐III	陀枪师姐III
王勃之死	王勃之死
东京审判	东京审判
近距离恋爱	近距离恋爱
狼狈	狼狈
铁血武工队传奇	铁血武工队传奇
绿鱼	绿鱼
马路情歌	马路情歌
红豆生南国	红豆生南国
非常突然	非常突然
陷入纯情	陷入纯情
曼青春	曼青春
007之黑日危机	007之黑日危机
建党伟业	建党伟业
急诊科医生	急诊科医生
大李小李和老李	大李小李和老李
我的八十年代	我的八十年代
梦精记	梦精记
登“封”造极	登“封”造极
V字仇杀队	V字仇杀队
速度与激情5	速度与激情5
速度与激情6	速度与激情6
侬本多情	侬本多情
夏威夷少年	夏威夷少年
何文秀	何文秀
晚安北京	晚安北京
九月飞鹰	九月飞鹰
幼儿园特警	幼儿园特警
办公室大爆炸	办公室大爆炸
如果没有你	如果没有你
非常岁月	非常岁月
十六岁的战争	十六岁的战争
阿甘正传	阿甘正传
金鸡sss	金鸡sss
加油妈妈	加油妈妈
迷失洛杉矶	迷失洛杉矶
自由飞翔	自由飞翔
一个人的情人节	一个人的情人节
神剑震江湖	神剑震江湖
认真的女人最美丽	认真的女人最美丽
山河故人	山河故人
旋风管家！	旋风管家！
有感情歌	有感情歌
第五共和国	第五共和国
飞行员小姐	飞行员小姐
闪亮茗天	闪亮茗天
美了美了	美了美了
新兵正传III：蛙人传	新兵正传III：蛙人传
美人为馅	美人为馅
我家的春秋冬夏	我家的春秋冬夏
喜羊羊与灰太狼	喜羊羊与灰太狼
林肯	林肯
大话西游	大话西游
学会	学会
凉生，我们可不可以不忧伤	凉生，我们可不可以不忧伤
狼牙	狼牙
抉择	抉择
爱味男女	爱味男女
太阳的女儿	太阳的女儿
风筝	风筝
东北往事之黑道风云20年	东北往事之黑道风云20年
康熙微服私访记3	康熙微服私访记3
黑百合住宅区	黑百合住宅区
熟女欲望日记	熟女欲望日记
说句心里话	说句心里话
野战排	野战排
国际刑警	国际刑警
一场游戏一场梦	一场游戏一场梦
温州一家人	温州一家人
别让我走	别让我走
我的未来不是梦	我的未来不是梦
家有喜事	家有喜事
你的柔情我永远不懂	你的柔情我永远不懂
高原蓝	高原蓝
起航吧少年	起航吧少年
武当	武当
毕业后的日子	毕业后的日子
向着炮火前进	向着炮火前进
空姐日记	空姐日记
报告班长	报告班长
志在四方2	志在四方2
nana	nana
可爱的玫瑰花	可爱的玫瑰花
美女与野兽	美女与野兽
雨人	雨人
决战刹马镇	决战刹马镇
世界末日的某个角落	世界末日的某个角落
牯岭街少年杀人事件	牯岭街少年杀人事件
漂亮主妇	漂亮主妇
一级恐惧	一级恐惧
另一个世界的事物	另一个世界的事物
完全的拥有	完全的拥有
李可乐寻人记	李可乐寻人记
绵羊	绵羊
鹰爪铁布衫	鹰爪铁布衫
秦始皇	秦始皇
单身公主相亲记	单身公主相亲记
Armistice	Armistice
警视厅搜查一课9系	警视厅搜查一课9系
灰色空间	灰色空间
斗牛	斗牛
非走不可	非走不可
旧日的足迹	旧日的足迹
LAST HOPE	LAST HOPE
真实之泪	真实之泪
青春漫画	青春漫画
遇见崆峒	遇见崆峒
丝绸之路	丝绸之路
爱情多恼河	爱情多恼河
要你看到我的美	要你看到我的美
灿烂的行走	灿烂的行走
告别时刻	告别时刻
一路上有你	一路上有你
沙城	沙城
孪生兄妹	孪生兄妹
哥本哈根的童话	哥本哈根的童话
马小跳	马小跳
午夜守门人	午夜守门人
豆腐迷郎	豆腐迷郎
我想我是海	我想我是海
爱杀	爱杀
锦绣缘	锦绣缘
菲律宾	菲律宾
快点告诉你	快点告诉你
飞龙猛将	飞龙猛将
华和家的四姐妹	华和家的四姐妹
来玩吧	来玩吧
光之美少女	光之美少女
大仙衙门	大仙衙门
汉明妃	汉明妃
太王四神记	太王四神记
刑警战记	刑警战记
伽马射线效应	伽马射线效应
马克斯，我的爱	马克斯，我的爱
霹雳菩萨	霹雳菩萨
杀人魔画	杀人魔画
爱爱爱	爱爱爱
手机	手机
感激时代	感激时代
无言的歌	无言的歌
面不改色	面不改色
真爱配方	真爱配方
艋舺燿辉	艋舺燿辉
杂家小子	杂家小子
平凡的事业	平凡的事业
拜托了，老师	拜托了，老师
原振侠	原振侠
天国的阶梯	天国的阶梯
阴天	阴天
白蛇与许仙	白蛇与许仙
we	we
有梦的孩子	有梦的孩子
绝地逃亡	绝地逃亡
阿雷路亚·帕普提兹姆	阿雷路亚·帕普提兹姆
如果有来生	如果有来生
夜行动物	夜行动物
弯刀	弯刀
梦幻天堂	梦幻天堂
双面玛莎	双面玛莎
孤儿乐园	孤儿乐园
伤城记	伤城记
海底两万里	海底两万里
西安事变	西安事变
桃姐	桃姐
小岁月太着急	小岁月太着急
娱乐没有圈	娱乐没有圈
不在犯罪现场	不在犯罪现场
识骨寻踪第五季	识骨寻踪第五季
爱的力量	爱的力量
想见你	想见你
爸妈不容易	爸妈不容易
最爱是谁	最爱是谁
封神英雄	封神英雄
庙街皇后	庙街皇后
姨妈的后现代生活	姨妈的后现代生活
国会议员郑治成失踪事件	国会议员郑治成失踪事件
the biggest dreamer	the biggest dreamer
那些一见钟情的事	那些一见钟情的事
抹去泪水	抹去泪水
野百合也有春天	野百合也有春天
芙蓉镇	芙蓉镇
六英尺下	六英尺下
小曼哈顿	小曼哈顿
天堂口	天堂口
飞虎神鹰	飞虎神鹰
秋缠	秋缠
许愿池艳遇	许愿池艳遇
我的爱	我的爱
长安三怪探	长安三怪探
shake it off	shake it off
再见雷普利小姐	再见雷普利小姐
梦醒了	梦醒了
风月俏佳人	风月俏佳人
放不低	放不低
白星	白星
女演员的管家	女演员的管家
健康生活每一天	健康生活每一天
樱花纷飞时	樱花纷飞时
比我幸福	比我幸福
球在你脚下	球在你脚下
奇异恩典	奇异恩典
客家之歌	客家之歌
真相	真相
诱惑	诱惑
武媚娘传奇	武媚娘传奇
一起来	一起来
魔高一丈	魔高一丈
二重唱	二重唱
赛车传奇	赛车传奇
特工皇妃楚乔传	特工皇妃楚乔传
爱情买卖	爱情买卖
降落伞	降落伞
第22条婚规	第22条婚规
比悲伤更悲伤的故事	比悲伤更悲伤的故事
合约男女	合约男女
芙蓉锦	芙蓉锦
信天游	信天游
傻阿甘	傻阿甘
经过	经过
事件救命医～IMAT的奇迹	事件救命医～IMAT的奇迹
憨憨漫游电脑世界	憨憨漫游电脑世界
kiss kiss	kiss kiss
寂寞难耐	寂寞难耐
护花使者	护花使者
情豆花开	情豆花开
摩登农夫	摩登农夫
好朋友	好朋友
我的爷爷	我的爷爷
少林搭棚大师	少林搭棚大师
同根生	同根生
是！尚先生	是！尚先生
未来日记-ANOTHER:WORLD-	未来日记-ANOTHER:WORLD-
龙凤斗	龙凤斗
我要反三俗	我要反三俗
托兆碰碑	托兆碰碑
阮玲玉	阮玲玉
全家福	全家福
鸭之一族	鸭之一族
Whatcha Say	Whatcha Say
公主的男人	公主的男人
土地	土地
无得比	无得比
天子寻龙	天子寻龙
孤单心事	孤单心事
地球上最浪漫的一首歌	地球上最浪漫的一首歌
宇宙牌香烟	宇宙牌香烟
美发师	美发师
无可救药	无可救药
唐明皇	唐明皇
盲人电影院	盲人电影院
钢琴家	钢琴家
我们走了一光年	我们走了一光年
三笑	三笑
宝石拌饭	宝石拌饭
妈妈吉利小叮当	妈妈吉利小叮当
rain	rain
我们都一样	我们都一样
神探狄仁杰第三部	神探狄仁杰第三部
江湖奇侠	江湖奇侠
Fallin'	Fallin'
Brand New Me	Brand New Me
八墓村	八墓村
星空	星空
无声的河	无声的河
1973	1973
鸡毛蒜皮没小事	鸡毛蒜皮没小事
物语系列	物语系列
继承者们	继承者们
love yourself	love yourself
一笑而过	一笑而过
警察进行曲	警察进行曲
天使也会哭	天使也会哭
僵尸家族	僵尸家族
公园	公园
里见八犬传	里见八犬传
小燕有约	小燕有约
幸福像花儿一样	幸福像花儿一样
真爱一世情	真爱一世情
In Your Eyes	In Your Eyes
真我霓裳	真我霓裳
My Name Is	My Name Is
鲨鱼鲨鱼	鲨鱼鲨鱼
到阜阳六百里	到阜阳六百里
边缘故事	边缘故事
戏说乾隆	戏说乾隆
京戏启示录	京戏启示录
六块六毛六那点事	六块六毛六那点事
急诊室故事	急诊室故事
两代厨房	两代厨房
金婚风雨情	金婚风雨情
王保长新篇	王保长新篇
强奸2制服诱惑	强奸2制服诱惑
借枪	借枪
失恋巧克力职人	失恋巧克力职人
玻璃丝袜	玻璃丝袜
美夕	美夕
part of me	part of me
天堂来的孩子	天堂来的孩子
月亮惹的祸	月亮惹的祸
两小无猜	两小无猜
新京华烟云	新京华烟云
活得像个笑话	活得像个笑话
李卫辞官	李卫辞官
黄淑仪入厨乐	黄淑仪入厨乐
我爱的是你爱我	我爱的是你爱我
夜行者	夜行者
飞越迷情	飞越迷情
特务J	特务J
你是猪么	你是猪么
月半弯	月半弯
Hands Up	Hands Up
大男当婚	大男当婚
大汉情缘之云中歌	大汉情缘之云中歌
无药医的爱	无药医的爱
樱桃	樱桃
战争与和平	战争与和平
午夜微博	午夜微博
美国派	美国派
间谍明月	间谍明月
红红大中国	红红大中国
爸爸再爱我一次	爸爸再爱我一次
这一拜	这一拜
下流人生	下流人生
天皇的料理人	天皇的料理人
藤堂平助	藤堂平助
咕噜咕噜魔法阵	咕噜咕噜魔法阵
新扎师妹	新扎师妹
算你狠	算你狠
澳门的故事	澳门的故事
叛逆之心	叛逆之心
金陵秘事	金陵秘事
波米叔叔的前世今生	波米叔叔的前世今生
龙八夷	龙八夷
太祖秘史	太祖秘史
1408幻影凶间	1408幻影凶间
追女仔	追女仔
谎言背后	谎言背后
兵变1938	兵变1938
忆长安	忆长安
预言者	预言者
百万粉丝	百万粉丝
天龙诀	天龙诀
风雨下钟山	风雨下钟山
常回家看看	常回家看看
蕾切尔的婚礼	蕾切尔的婚礼
一路向西	一路向西
W的悲剧	W的悲剧
醒了	醒了
脱掉	脱掉
一页台北	一页台北
中原中也	中原中也
请你继续爱我	请你继续爱我
爱不释手	爱不释手
郭襄	郭襄
传闻中的七公主	传闻中的七公主
山丹丹	山丹丹
鸿门宴	鸿门宴
偷窥女教师	偷窥女教师
当爱来的时候	当爱来的时候
乱世妖姬	乱世妖姬
华丽上班族	华丽上班族
新娘与我	新娘与我
爱情公寓	爱情公寓
遇见幸福300天	遇见幸福300天
憨媳当家	憨媳当家
我爱你 U	我爱你 U
恭喜发财	恭喜发财
绝色双娇	绝色双娇
居尔特	居尔特
卑微的承诺	卑微的承诺
你邻居的妻子	你邻居的妻子
宪兵队的故事	宪兵队的故事
飞天神鼠	飞天神鼠
爱德·菲尼克斯	爱德·菲尼克斯
迷途追凶	迷途追凶
天涯共此时	天涯共此时
当幸福来敲门	当幸福来敲门
金大花的华丽冒险	金大花的华丽冒险
真爱之百万新娘	真爱之百万新娘
赎罪	赎罪
我恋爱的一切	我恋爱的一切
五妹	五妹
凉宫春日的忧郁	凉宫春日的忧郁
Still Waiting	Still Waiting
空巢	空巢
百团大战	百团大战
风真透	风真透
青花	青花
天津	天津
what the hell	what the hell
No Breathing	No Breathing
天才宝贝	天才宝贝
跤王	跤王
我爱我车	我爱我车
土地公	土地公
第一次亲密接触	第一次亲密接触
一念执着	一念执着
大宅门第二部	大宅门第二部
我的童年	我的童年
薛仁贵征东	薛仁贵征东
盗火线	盗火线
上海大风暴	上海大风暴
座头市	座头市
三岛由纪夫	三岛由纪夫
赌侠	赌侠
错位青春	错位青春
边走边唱	边走边唱
家庭幽默录像	家庭幽默录像
洪武三十二	洪武三十二
地下铁	地下铁
首尔	首尔
壹周·立波秀	壹周·立波秀
Family Affair	Family Affair
沙哑	沙哑
无人驾驶	无人驾驶
孽子	孽子
Mirrors	Mirrors
甲午风云	甲午风云
中国话	中国话
爱我生活	爱我生活
那些你们喜欢的不喜欢的我都喜欢的女孩	那些你们喜欢的不喜欢的我都喜欢的女孩
喜爱夜蒲2	喜爱夜蒲2
喜爱夜蒲3	喜爱夜蒲3
柠檬汽水	柠檬汽水
猫眼三姐妹	猫眼三姐妹
生缘	生缘
太平轮	太平轮
独有英雄	独有英雄
盛世莲花	盛世莲花
恋爱初歌	恋爱初歌
台湾霹雳火	台湾霹雳火
保姆	保姆
伤心是一种说不出的痛	伤心是一种说不出的痛
天涯	天涯
青春期撞上更年期	青春期撞上更年期
时空恋旅人	时空恋旅人
极限挑战	极限挑战
一树桃花开	一树桃花开
万历首辅张居正	万历首辅张居正
残酷一叮	残酷一叮
糊涂县令郑板桥	糊涂县令郑板桥
儿子	儿子
爱能给别人吗	爱能给别人吗
青涩季节	青涩季节
陪安东尼度过漫长岁月	陪安东尼度过漫长岁月
平凡的世界	平凡的世界
狐狸与棉花糖	狐狸与棉花糖
云河	云河
不要说我坏	不要说我坏
人间失格	人间失格
寒山潜龙	寒山潜龙
龙拳小子	龙拳小子
刺马	刺马
盗版猫	盗版猫
韦瓦第计划	韦瓦第计划
玲珑局	玲珑局
派遣员的品格	派遣员的品格
无敌珊宝妹	无敌珊宝妹
疯女人日记	疯女人日记
月球漫步	月球漫步
丽兹与迪克	丽兹与迪克
美人草	美人草
来来往往	来来往往
我们结婚了世界篇	我们结婚了世界篇
日落之前爱上你	日落之前爱上你
Give It To Me	Give It To Me
主演	主演
回想	回想
地雷战	地雷战
勇敢去爱	勇敢去爱
欢乐音雄	欢乐音雄
婚前协议	婚前协议
遥远的她	遥远的她
甘巴拉	甘巴拉
神风刀	神风刀
全能囧爸	全能囧爸
因为是你	因为是你
多蒙·卡修	多蒙·卡修
世纪末的华丽	世纪末的华丽
火星救援	火星救援
医家四姐妹	医家四姐妹
惧高症	惧高症
痴心换情深	痴心换情深
只爱你一个	只爱你一个
风过雨无停	风过雨无停
四美图	四美图
江湖情	江湖情
游戏王ZEXAL	游戏王ZEXAL
Burn	Burn
爱情这杯酒谁喝都得醉	爱情这杯酒谁喝都得醉
烈火	烈火
菜鸟刑警	菜鸟刑警
黑客帝国	黑客帝国
托儿	托儿
单亲之家	单亲之家
长梦留痕	长梦留痕
翡翠恋人	翡翠恋人
热血青春	热血青春
傻	傻
你是我的姐妹	你是我的姐妹
忍冬艳蔷薇	忍冬艳蔷薇
望江亭	望江亭
带子英雄	带子英雄
侠侣探案	侠侣探案
纯爱新娘	纯爱新娘
名家	名家
Hard to love, How to love	Hard to love, How to love
彩云伴海鸥	彩云伴海鸥
小泉千佳	小泉千佳
中原镖局	中原镖局
龙虎门	龙虎门
神啊，请给我多一点时间	神啊，请给我多一点时间
风华正茂	风华正茂
邓小平	邓小平
逆光飞翔	逆光飞翔
被解救的姜戈	被解救的姜戈
火煮三国	火煮三国
黑色共和国	黑色共和国
晚安，好运	晚安，好运
都铎王朝	都铎王朝
满城尽带黄金甲	满城尽带黄金甲
魔镜	魔镜
My Darling	My Darling
推理笔记	推理笔记
事件	事件
爱的代价	爱的代价
brave	brave
少年	少年
五月之恋	五月之恋
战长沙	战长沙
火影忍者	火影忍者
大韩民国律师	大韩民国律师
雾柳镇	雾柳镇
茶颂	茶颂
不落的太阳	不落的太阳
日光倾城	日光倾城
米尔克	米尔克
老九门	老九门
不能说的秘密	不能说的秘密
总有骄阳	总有骄阳
原来你一直都在	原来你一直都在
冷月孤星剑	冷月孤星剑
一个人走	一个人走
龙行天下	龙行天下
快乐的单身汉	快乐的单身汉
西区故事	西区故事
人造雪	人造雪
全职猎人	全职猎人
欢乐喜剧人第二季	欢乐喜剧人第二季
v	v
银河护卫队	银河护卫队
生死速递	生死速递
方子传	方子传
2:37	2:37
鬼迷心窍	鬼迷心窍
幻想巨塔	幻想巨塔
爱情中毒	爱情中毒
地道女英雄	地道女英雄
change	change
少年不哭	少年不哭
意难忘	意难忘
绝对一对	绝对一对
婚迷不醒	婚迷不醒
天幕下的恋人	天幕下的恋人
热门花招	热门花招
冬雨	冬雨
无人守护	无人守护
中国娱乐报道	中国娱乐报道
少帅	少帅
逃学外传	逃学外传
U KNOW Y	U KNOW Y
誓言今生	誓言今生
问花	问花
想要爱	想要爱
印象西湖雨	印象西湖雨
宿命	宿命
杨善洲	杨善洲
排球女将	排球女将
不打烊的小酒馆	不打烊的小酒馆
相逢一笑	相逢一笑
负二代的幸福生活	负二代的幸福生活
无限生机	无限生机
缘份的天空	缘份的天空
战能少年	战能少年
零炮楼	零炮楼
真情无限之养母·生母	真情无限之养母·生母
双星报喜	双星报喜
功夫好男儿	功夫好男儿
碧绿色的兔子	碧绿色的兔子
缘，妙不可言	缘，妙不可言
金星	金星
深深打破	深深打破
星期六晚上	星期六晚上
疯狂的钻石	疯狂的钻石
自然醒	自然醒
野草莓	野草莓
美丽坏东西	美丽坏东西
九尾狐与仙鹤	九尾狐与仙鹤
福尔摩斯二世	福尔摩斯二世
送你一朵山茶花	送你一朵山茶花
someone like you	someone like you
闪耀的罗曼史	闪耀的罗曼史
超人归来	超人归来
宁夏	宁夏
诗	诗
WONDERLAND	WONDERLAND
我愿是只小燕	我愿是只小燕
分飞	分飞
爱你至死不渝	爱你至死不渝
随时候命	随时候命
每当变幻时	每当变幻时
紫金镖	紫金镖
万水千山总是情	万水千山总是情
牛车水人家	牛车水人家
烈焰	烈焰
女人不是月亮	女人不是月亮
花雨夜	花雨夜
武术班	武术班
花花宇宙	花花宇宙
永远	永远
内在美	内在美
隐形的翅膀	隐形的翅膀
以眼杀人	以眼杀人
spy	spy
超级战警	超级战警
红樱桃	红樱桃
春来了	春来了
爱上草原爱上你	爱上草原爱上你
盲山	盲山
今生缘	今生缘
我们	我们
美丽的契约	美丽的契约
批三国	批三国
万万没想到	万万没想到
当我再爱你的时候	当我再爱你的时候
锦衣卫	锦衣卫
紫禁之巅	紫禁之巅
茶馆	茶馆
真空爱情记录	真空爱情记录
分手合约	分手合约
青春纪念册	青春纪念册
哭别	哭别
银狐	银狐
甘心情愿	甘心情愿
古墓丽影	古墓丽影
迷失世界	迷失世界
优莱卡	优莱卡
人间风雨情	人间风雨情
大秦帝国之纵横	大秦帝国之纵横
即使知道要见面	即使知道要见面
迎客来	迎客来
撒娇女人最好命	撒娇女人最好命
花样年华	花样年华
X战警：逆转未来	X战警：逆转未来
迷路	迷路
翼·年代记	翼·年代记
X战警：天启	X战警：天启
杜鹃之巢	杜鹃之巢
我的生存时间	我的生存时间
赏金猎人	赏金猎人
奔跑卡路里	奔跑卡路里
神奇	神奇
垫底辣妹	垫底辣妹
台湾龙卷风	台湾龙卷风
富贵男与贫穷女	富贵男与贫穷女
蜜桃女孩	蜜桃女孩
别离开	别离开
百合	百合
一块红布	一块红布
狼牙山五壮士	狼牙山五壮士
速度与激情3：东京漂移	速度与激情3：东京漂移
性工作者2：我不卖身·我卖子宫	性工作者2：我不卖身·我卖子宫
Regulate	Regulate
娱乐乐翻天	娱乐乐翻天
托尼·史塔克	托尼·史塔克
特警力量	特警力量
往事随风	往事随风
嫁一	嫁一
雷欧·奥特曼	雷欧·奥特曼
机动新世纪高达X	机动新世纪高达X
天降之物	天降之物
Jay	Jay
世上最美的歌	世上最美的歌
舌尖上的中国	舌尖上的中国
猿飞菖蒲	猿飞菖蒲
女人一辈子	女人一辈子
古怪因子	古怪因子
仁顺真美丽	仁顺真美丽
外来妹	外来妹
暧昧	暧昧
台湾灵异事件	台湾灵异事件
残酷月光	残酷月光
伍声	伍声
宇宙战舰大和号	宇宙战舰大和号
分开不一定分手	分开不一定分手
嘻哈四重奏	嘻哈四重奏
聊斋外传	聊斋外传
包拯	包拯
中华人民共和国国旗	中华人民共和国国旗
游侠儿	游侠儿
爱的不是我	爱的不是我
志在四方	志在四方
热血三兄弟	热血三兄弟
奔腾年代	奔腾年代
亡命之逃	亡命之逃
思念母亲	思念母亲
放下你的鞭子	放下你的鞭子
北京，我的爱	北京，我的爱
银牙传说WEED	银牙传说WEED
早安老师	早安老师
白鹿原	白鹿原
绿色军衣	绿色军衣
听着你的歌	听着你的歌
南北	南北
惊天动地	惊天动地
咏春小龙	咏春小龙
血荐轩辕	血荐轩辕
老男孩之猛龙过江	老男孩之猛龙过江
神犬小七第二季	神犬小七第二季
十月初五的月光	十月初五的月光
漂浪青春	漂浪青春
黄金印	黄金印
以后我们住这里	以后我们住这里
刑事侦缉档案Ⅲ	刑事侦缉档案Ⅲ
光荣之旅	光荣之旅
新警事	新警事
嫂嫂19岁	嫂嫂19岁
BEGINNERS	BEGINNERS
我热恋的故乡	我热恋的故乡
甲天下	甲天下
舞-HIME	舞-HIME
两天一夜第二季	两天一夜第二季
胜者为王	胜者为王
全世界恋爱	全世界恋爱
热情似火	热情似火
爱情的条件	爱情的条件
心愿便利贴	心愿便利贴
梦想歌	梦想歌
大追捕	大追捕
项少羽	项少羽
冲天火	冲天火
瞧这两家子	瞧这两家子
重案六组3	重案六组3
重案六组4	重案六组4
七月七日晴	七月七日晴
闺蜜	闺蜜
心灵的阳光	心灵的阳光
我不快乐	我不快乐
醉拳	醉拳
好朋友的祝福	好朋友的祝福
大老婆小老公	大老婆小老公
今夜星光诱惑	今夜星光诱惑
长崎漫步曲	长崎漫步曲
文艺编导班	文艺编导班
心会跟爱一起走	心会跟爱一起走
妻子的谎言	妻子的谎言
屌丝男士	屌丝男士
澳囧	澳囧
连环泡	连环泡
逃亡者	逃亡者
抓住彩虹的男人	抓住彩虹的男人
轮滑女孩	轮滑女孩
蓝色激情	蓝色激情
DISCO	DISCO
非常周末	非常周末
小侠龙旋风	小侠龙旋风
盗钥匙的方法	盗钥匙的方法
恋爱兵法	恋爱兵法
举起手来	举起手来
Secret Code	Secret Code
水岸	水岸
男人的香气	男人的香气
第一纵队	第一纵队
翠浓	翠浓
百万美元宝贝	百万美元宝贝
太子妃升职记	太子妃升职记
约会之夜	约会之夜
艳粉街的故事	艳粉街的故事
我要当八路	我要当八路
今生今世	今生今世
在灿烂阳光下	在灿烂阳光下
导火新闻线	导火新闻线
天使的城	天使的城
云画的月光	云画的月光
抹布女也有春天	抹布女也有春天
神本円佳	神本円佳
非常女警	非常女警
庄妃轶事	庄妃轶事
南京爱情	南京爱情
女检察官	女检察官
小爸妈	小爸妈
你寂寞才找我	你寂寞才找我
刁蛮公主逍遥王	刁蛮公主逍遥王
汉武大帝	汉武大帝
首尔情人	首尔情人
独立纵队2	独立纵队2
花	花
泉水叮咚	泉水叮咚
跟着太阳走	跟着太阳走
囡囡	囡囡
放弃	放弃
雏妓	雏妓
Transit Girls	Transit Girls
不老传说	不老传说
正义联盟	正义联盟
梦精记2	梦精记2
指望	指望
三岔口	三岔口
一个人的天荒地老	一个人的天荒地老
欲爱不能	欲爱不能
在劫难逃	在劫难逃
爱情白皮书	爱情白皮书
剩女保镖	剩女保镖
最遥远的银河	最遥远的银河
我们约会吧+	我们约会吧+
多想把你抱住	多想把你抱住
春姑娘	春姑娘
镖门	镖门
花为媒	花为媒
爱德华大夫	爱德华大夫
少林小子方世玉	少林小子方世玉
沐浴阳光	沐浴阳光
罗马帝国艳情史	罗马帝国艳情史
演歌	演歌
爱是你眼里的一首情歌	爱是你眼里的一首情歌
松花江上	松花江上
突破	突破
贩马记	贩马记
成成烽火	成成烽火
我是杜拉拉	我是杜拉拉
爱情曲别针	爱情曲别针
绝命毒师	绝命毒师
八大豪侠	八大豪侠
白色情人梦	白色情人梦
悲怆第四乐章	悲怆第四乐章
一起来看流星雨	一起来看流星雨
嗜血判官	嗜血判官
看不见的爱	看不见的爱
潇洒走一回	潇洒走一回
夕鹤	夕鹤
骆驼祥子	骆驼祥子
喜剧学院	喜剧学院
色情男女	色情男女
侠女十三妹	侠女十三妹
伤城	伤城
杀手天使	杀手天使
青春期	青春期
假面骑士剑	假面骑士剑
剑啸江湖	剑啸江湖
静止	静止
结婚狂想曲	结婚狂想曲
将爱情进行到底2	将爱情进行到底2
吸血鬼的阴影	吸血鬼的阴影
松药店的儿子们	松药店的儿子们
欢乐总动员	欢乐总动员
妄想学生会	妄想学生会
司文郎	司文郎
玩笑话	玩笑话
终极Ⅹ宿舍	终极Ⅹ宿舍
穆赫兰道	穆赫兰道
苦恼人的笑	苦恼人的笑
左右手	左右手
战地花开	战地花开
爱情回来了	爱情回来了
PRESS IT	PRESS IT
西风烈	西风烈
乡村名流	乡村名流
壮志骄阳	壮志骄阳
喜乐街	喜乐街
我的青春在延安	我的青春在延安
仁慈之女～国税局稽查官～	仁慈之女～国税局稽查官～
新世界	新世界
猛然遇见你	猛然遇见你
forever	forever
封神英雄榜	封神英雄榜
一起摇摆	一起摇摆
欢迎来到东莫村	欢迎来到东莫村
寂寞寂寞就好	寂寞寂寞就好
中国功夫	中国功夫
阳光灿烂的日子	阳光灿烂的日子
魔女幼熙	魔女幼熙
赤壁	赤壁
十二怒汉	十二怒汉
新燕子李三	新燕子李三
北平往事	北平往事
在每一条伤心的应天大街上	在每一条伤心的应天大街上
闰秒	闰秒
铁马寻桥	铁马寻桥
流浪王子	流浪王子
鱼跃在花见	鱼跃在花见
十兄弟	十兄弟
贱女孩	贱女孩
潜行者	潜行者
孽债	孽债
我的左手右手	我的左手右手
初到东京	初到东京
让女人哭泣	让女人哭泣
双鱼	双鱼
鬼丈夫	鬼丈夫
枫叶红了的时候	枫叶红了的时候
和雨跳舞	和雨跳舞
谁是真英雄	谁是真英雄
卡萨布兰卡	卡萨布兰卡
信自己	信自己
红色娘子军	红色娘子军
十年痛痒	十年痛痒
雪之花	雪之花
飞天	飞天
Again!!重来一次	Again!!重来一次
酒魂	酒魂
母亲的战争	母亲的战争
加州旅馆	加州旅馆
哪里怕	哪里怕
说来有点可笑	说来有点可笑
大赌豪	大赌豪
云朵	云朵
祥云县	祥云县
丸尾末男	丸尾末男
北斗神拳	北斗神拳
奶酪陷阱	奶酪陷阱
街头风云之地下秩序	街头风云之地下秩序
真幌站前狂骚曲	真幌站前狂骚曲
杀破狼2	杀破狼2
犬神	犬神
女人天下	女人天下
H.I.T	H.I.T
EU超时任务	EU超时任务
红旗谱	红旗谱
我的心是油炸的蚕豆	我的心是油炸的蚕豆
状王宋世杰	状王宋世杰
午夜凶铃	午夜凶铃
谢谢有你	谢谢有你
无法消除的罪恶	无法消除的罪恶
茧镇奇缘	茧镇奇缘
菜鸟评审员	菜鸟评审员
黄飞鸿之英雄有梦	黄飞鸿之英雄有梦
诺丁山	诺丁山
魔境仙踪	魔境仙踪
拥抱太阳的月亮	拥抱太阳的月亮
花红花火	花红花火
绽放	绽放
EMI	EMI
迷迭香	迷迭香
间谍佐尔格	间谍佐尔格
结婚禁行曲	结婚禁行曲
billie jean	billie jean
变形金刚	变形金刚
看得最远的地方	看得最远的地方
爸爸，爸爸	爸爸，爸爸
天堂书屋：恋火	天堂书屋：恋火
不了情	不了情
女黑侠木兰花	女黑侠木兰花
朋友	朋友
赤裸特工	赤裸特工
省港大营救	省港大营救
3	3
镜音铃	镜音铃
料理情人梦	料理情人梦
龙樱	龙樱
Highway Don't Care	Highway Don't Care
麻辣女兵	麻辣女兵
假面	假面
同窗生	同窗生
B.o.B	B.o.B
兴夫家的葫芦开了	兴夫家的葫芦开了
记忆之城	记忆之城
黄金苹果	黄金苹果
媳妇的全盛时代	媳妇的全盛时代
玉梨魂	玉梨魂
万世师表	万世师表
败家仔	败家仔
爱久见人心	爱久见人心
称霸舞林	称霸舞林
火车	火车
影迷	影迷
新亮剑	新亮剑
X-Girl	X-Girl
幕府将军	幕府将军
新参者	新参者
回来吧顺爱	回来吧顺爱
通缉令	通缉令
九九九毒天鹅	九九九毒天鹅
不凡的爱	不凡的爱
有一种毒药	有一种毒药
铠甲勇士	铠甲勇士
can't get you out of my head	can't get you out of my head
追鱼传奇	追鱼传奇
我相信	我相信
青春×机关枪	青春×机关枪
翻译风波	翻译风波
黎明行动	黎明行动
超级大赢家	超级大赢家
狐狸呀，你在做什么	狐狸呀，你在做什么
求婚大作战	求婚大作战
重生之名流巨星	重生之名流巨星
天天天晴	天天天晴
苏菲日记	苏菲日记
爱情能用钱买吗	爱情能用钱买吗
空城	空城
我爱过的那个人	我爱过的那个人
都市和尚	都市和尚
海韵魅影	海韵魅影
大鹏嘚吧嘚	大鹏嘚吧嘚
男人四十要出嫁	男人四十要出嫁
血溅虎头门	血溅虎头门
大中国	大中国
Doctors	Doctors
杨门虎将	杨门虎将
太真外传	太真外传
聚宝盆	聚宝盆
我要当空姐	我要当空姐
魔神Z	魔神Z
吉祥三宝	吉祥三宝
amani	amani
绣娘兰馨	绣娘兰馨
大明宫词	大明宫词
薄樱鬼	薄樱鬼
初缠恋后的二人世界	初缠恋后的二人世界
Kardashian Kollection	Kardashian Kollection
伟大的隐藏者	伟大的隐藏者
美剧	美剧
杀人回忆	杀人回忆
生活大爆炸	生活大爆炸
两个冬天	两个冬天
我的法兰西岁月	我的法兰西岁月
朋友再见	朋友再见
丈夫得了抑郁症	丈夫得了抑郁症
力王	力王
少女灵异日记	少女灵异日记
产科男医生	产科男医生
古墓女友	古墓女友
用一生去爱你	用一生去爱你
上海皇帝之雄霸天下	上海皇帝之雄霸天下
神机妙算刘伯温	神机妙算刘伯温
京华春梦	京华春梦
梦未央	梦未央
人面桃花	人面桃花
沙希	沙希
哈佛爱情故事	哈佛爱情故事
年轻人	年轻人
AIR	AIR
江·公主们的战国	江·公主们的战国
父亲	父亲
Air City	Air City
爱可以重来	爱可以重来
旧情绵绵	旧情绵绵
星语心愿之再爱	星语心愿之再爱
我的名字叫可汗	我的名字叫可汗
冬季到台北来看雨	冬季到台北来看雨
求求你表扬我	求求你表扬我
受了点伤	受了点伤
我的青春恋爱物语果然有问题。	我的青春恋爱物语果然有问题。
夜来香	夜来香
怪奇大家族	怪奇大家族
中华英雄	中华英雄
人间情多	人间情多
红豆红	红豆红
花房姑娘	花房姑娘
好朋友们2014	好朋友们2014
校墓处	校墓处
摩诃般若波罗蜜多心经	摩诃般若波罗蜜多心经
酷马	酷马
指间的重量	指间的重量
营盘镇警事	营盘镇警事
蚁族的奋斗	蚁族的奋斗
点亮世界	点亮世界
天使之争	天使之争
万事胜意	万事胜意
五个扑水的少年	五个扑水的少年
裸婚之后	裸婚之后
依恋	依恋
佛光寺传奇	佛光寺传奇
两个人一双手	两个人一双手
百变爱人	百变爱人
琥珀	琥珀
千古	千古
宝莱坞生死恋	宝莱坞生死恋
盗墓笔记	盗墓笔记
绝色武器	绝色武器
英烈千秋	英烈千秋
巧妇怨	巧妇怨
小伙的蔬菜店	小伙的蔬菜店
醉打金枝	醉打金枝
汝矣岛	汝矣岛
勿忘心安	勿忘心安
老婆最大	老婆最大
幸福百分百	幸福百分百
LOVE ME RIGHT	LOVE ME RIGHT
李先念	李先念
poker face	poker face
他们在相爱	他们在相爱
驴得水	驴得水
咖啡馆的故事	咖啡馆的故事
九星报喜	九星报喜
破阵	破阵
告白	告白
风中的承诺	风中的承诺
田井中律	田井中律
内向的老板	内向的老板
僵尸先生	僵尸先生
浪子心声	浪子心声
爱你	爱你
牧马人	牧马人
热血长安	热血长安
踏血寻梅	踏血寻梅
千山暮雪	千山暮雪
风儿别敲我窗	风儿别敲我窗
迷魂记	迷魂记
无知	无知
霍桑探案	霍桑探案
海啸奇迹	海啸奇迹
生死朗读	生死朗读
航海王	航海王
睡公主	睡公主
小白杨	小白杨
港督最后一个保镖	港督最后一个保镖
齐天大圣孙悟空	齐天大圣孙悟空
听说	听说
新扎师兄	新扎师兄
我居住的地方	我居住的地方
东京塔	东京塔
仙剑奇侠传三	仙剑奇侠传三
我是证人	我是证人
无眠	无眠
军阀趣史	军阀趣史
SHARK 第2季	SHARK 第2季
单亲插班生	单亲插班生
柔道龙虎榜	柔道龙虎榜
老表，你好Hea!	老表，你好Hea!
摩铁路之城	摩铁路之城
欺诈游戏	欺诈游戏
Checkmate	Checkmate
额吉	额吉
无因的反叛	无因的反叛
悲伤恋歌	悲伤恋歌
开心大冒险	开心大冒险
最寒冷的季节	最寒冷的季节
死者之学园祭	死者之学园祭
亲亲的老百姓	亲亲的老百姓
咸鱼	咸鱼
大太阳	大太阳
给你们	给你们
必胜练习生	必胜练习生
超人回来了	超人回来了
断奶	断奶
家和万事兴	家和万事兴
万家有宝	万家有宝
我的野蛮女老师	我的野蛮女老师
露比	露比
太平公主秘史	太平公主秘史
爱上两个我	爱上两个我
追梦人	追梦人
情字诀	情字诀
刀塔2	刀塔2
叛逃	叛逃
笑傲江湖Ⅱ：东方不败	笑傲江湖Ⅱ：东方不败
拉威尔	拉威尔
如果有一件事是重要的	如果有一件事是重要的
海岛迷杀	海岛迷杀
艺伎回忆录	艺伎回忆录
黄金驿站	黄金驿站
寂寞让我如此美丽	寂寞让我如此美丽
小别离	小别离
小神龙俱乐部	小神龙俱乐部
悲伤的秋千	悲伤的秋千
第三医院	第三医院
两天一夜	两天一夜
通天犀	通天犀
go away	go away
美丽邻居	美丽邻居
杨玉环	杨玉环
万古流芳	万古流芳
Fate/stay night [Unlimited Blade Works]	Fate/stay night [Unlimited Blade Works]
栀子花开	栀子花开
樱木花道	樱木花道
Why so lonely	Why so lonely
芝加哥	芝加哥
Yes? No?	Yes? No?
枉凝眉	枉凝眉
爆丸小子	爆丸小子
渴望	渴望
莫小白的水怪日记	莫小白的水怪日记
胜女的代价	胜女的代价
亲亲	亲亲
边境杀手	边境杀手
毁灭之路	毁灭之路
伤痕我心	伤痕我心
Hard Out Here	Hard Out Here
橙色岁月	橙色岁月
搏击俱乐部	搏击俱乐部
古堡之吻	古堡之吻
我的心太乱	我的心太乱
勇夺芳心	勇夺芳心
流着泪说分手	流着泪说分手
家族庆典	家族庆典
热情	热情
原味的夏天	原味的夏天
深度谜案	深度谜案
对不起，我爱你	对不起，我爱你
smiley face	smiley face
山田君与7人魔女	山田君与7人魔女
剑雨	剑雨
亲爱的中国我爱你	亲爱的中国我爱你
你是我的唯一	你是我的唯一
全城通缉	全城通缉
少年黄飞鸿之铁马骝	少年黄飞鸿之铁马骝
风中奇缘	风中奇缘
蝉时雨	蝉时雨
勇敢的兄弟	勇敢的兄弟
元帅之死	元帅之死
血，总是热的	血，总是热的
1699桃花扇	1699桃花扇
双重赔偿	双重赔偿
武士的家用帐	武士的家用帐
萌的或然率	萌的或然率
树大招风	树大招风
蓝鱼	蓝鱼
无形杀	无形杀
In control	In control
假如爱有天意	假如爱有天意
冰淇淋	冰淇淋
车站的故事	车站的故事
南京！南京！	南京！南京！
我们说好的	我们说好的
大脚走天下	大脚走天下
青春风暴	青春风暴
林世荣	林世荣
其乐融融	其乐融融
Darling	Darling
不可饶恕	不可饶恕
The Dutchess	The Dutchess
女篮五号	女篮五号
上瘾	上瘾
有你爱过也算是一种满足	有你爱过也算是一种满足
功名十字路	功名十字路
杀手情	杀手情
豪勇七蛟龙	豪勇七蛟龙
图书馆员	图书馆员
惊天魔盗团	惊天魔盗团
王的盛宴	王的盛宴
长剑相思	长剑相思
生活秀	生活秀
实尾岛	实尾岛
BANDAGE	BANDAGE
心中的遗憾	心中的遗憾
女高怪谈	女高怪谈
天生一对	天生一对
上错花轿嫁对郎	上错花轿嫁对郎
大海	大海
七种武器之孔雀翎	七种武器之孔雀翎
茉莉花	茉莉花
吻得太逼真	吻得太逼真
新娘18岁	新娘18岁
风流才子纪晓岚	风流才子纪晓岚
心理罪第二季	心理罪第二季
三朵花	三朵花
晴天娃娃	晴天娃娃
战争之王	战争之王
这时对那时错	这时对那时错
饿狼传说	饿狼传说
51号兵站	51号兵站
爱情降临	爱情降临
亲爱的你在哪里	亲爱的你在哪里
临床犯罪学者火村英生的推理	临床犯罪学者火村英生的推理
保镖之翡翠娃娃	保镖之翡翠娃娃
绿色玫瑰	绿色玫瑰
圣诞节会下雪吗？	圣诞节会下雪吗？
爱人	爱人
实名制	实名制
血色玫瑰之女子特遣队	血色玫瑰之女子特遣队
呼吸我	呼吸我
一个好人	一个好人
八重之樱	八重之樱
霍比特人：意外之旅	霍比特人：意外之旅
1988：我想和这个世界谈谈	1988：我想和这个世界谈谈
回忆里的那个人	回忆里的那个人
如此美好	如此美好
call you tonight	call you tonight
样样红	样样红
楼奴	楼奴
北极星	北极星
睡拳怪招	睡拳怪招
被偷走的那五年	被偷走的那五年
畹町桥	畹町桥
让人生畏的女人	让人生畏的女人
劝和小组	劝和小组
周总理你在哪里	周总理你在哪里
历史永远铭记	历史永远铭记
聪明的一休	聪明的一休
报告典狱长	报告典狱长
后宫	后宫
其实你不懂我的心	其实你不懂我的心
相信你	相信你
不会忘记	不会忘记
辣妈辣妹	辣妈辣妹
雪中情	雪中情
天空	天空
野鸭子	野鸭子
男儿当自强	男儿当自强
天庥日记	天庥日记
凌汤圆	凌汤圆
花好月更圆	花好月更圆
刘伯承元帅	刘伯承元帅
开国领袖毛泽东	开国领袖毛泽东
大闹天竺	大闹天竺
去海边吧	去海边吧
赤足天使	赤足天使
乱世儿女	乱世儿女
铁血淞沪	铁血淞沪
正义的伙伴	正义的伙伴
崀山生死恋	崀山生死恋
走出硝烟的女人	走出硝烟的女人
little star 星光	little star 星光
鬼域	鬼域
九百九十九朵玫瑰	九百九十九朵玫瑰
听说桐岛要退部	听说桐岛要退部
如今世道	如今世道
两个爸爸	两个爸爸
幸福妈妈	幸福妈妈
大爱	大爱
一个人游游荡荡	一个人游游荡荡
亲情保卫战	亲情保卫战
刀尖上的搏杀	刀尖上的搏杀
丛林的鱼2	丛林的鱼2
深爱着你	深爱着你
谍战深海	谍战深海
战雷神	战雷神
幸福的眼泪	幸福的眼泪
木棉花的春天	木棉花的春天
白娘子传奇	白娘子传奇
摇摇欲坠	摇摇欲坠
The beginning	The beginning
天窗	天窗
亲爱的，好久不见	亲爱的，好久不见
花样爷爷侦察队	花样爷爷侦察队
秦颂	秦颂
跛豪	跛豪
太阳岛上	太阳岛上
如果你不爱我	如果你不爱我
浪漫的事	浪漫的事
橙月	橙月
星光都市	星光都市
广播明星	广播明星
乌金血剑	乌金血剑
美人图	美人图
过好年	过好年
除恶帮阵八	除恶帮阵八
华颐：吞噬怪物的孩子	华颐：吞噬怪物的孩子
铁猴子传奇之江南义事	铁猴子传奇之江南义事
夺命岛	夺命岛
孤岛惊魂2	孤岛惊魂2
石器时代之百万大侦探	石器时代之百万大侦探
边关烽火情	边关烽火情
白日梦想家	白日梦想家
大物	大物
激浪青春	激浪青春
穿过海的声音	穿过海的声音
画皮之诡面少女	画皮之诡面少女
天云山传奇	天云山传奇
红狐行动	红狐行动
我和我的他们	我和我的他们
体操男孩	体操男孩
别有动机	别有动机
不再爱了	不再爱了
天台爱情	天台爱情
玛丽外宿中	玛丽外宿中
左手亲情右手爱	左手亲情右手爱
男生女生黑白配	男生女生黑白配
革命人永远是年轻	革命人永远是年轻
后厨	后厨
邻居的耳朵	邻居的耳朵
大创业家	大创业家
当爱在靠近	当爱在靠近
黑冰	黑冰
德古拉	德古拉
男人四十	男人四十
痞子英雄	痞子英雄
If I Were A Boy	If I Were A Boy
菊花吟	菊花吟
独立纵队	独立纵队
井	井
美丽	美丽
幸福迷途	幸福迷途
仙剑奇侠传六	仙剑奇侠传六
女人韵事	女人韵事
下妻物语	下妻物语
唯美生存	唯美生存
超级大英雄	超级大英雄
欢乐颂	欢乐颂
Fate/Zero	Fate/Zero
大火	大火
头文字D	头文字D
挖洞人	挖洞人
蓝江传之反飞组风云	蓝江传之反飞组风云
魔鬼女教头	魔鬼女教头
湘南起义	湘南起义
苹果	苹果
花心情圣	花心情圣
星之金币	星之金币
旋转卡门	旋转卡门
五号特工组	五号特工组
I GOT LOVE	I GOT LOVE
友情的界限	友情的界限
双璧传说	双璧传说
警察故事3超级警察	警察故事3超级警察
争分夺秒	争分夺秒
搜孤救孤	搜孤救孤
鸡毛飞上天	鸡毛飞上天
电灯胆	电灯胆
不堪回首	不堪回首
粉红色的回忆	粉红色的回忆
极恶非道	极恶非道
四月物语	四月物语
回到三国	回到三国
雀台歌女	雀台歌女
昨夜	昨夜
甜心俏佳人	甜心俏佳人
冲击	冲击
我也可以是流浪诗人	我也可以是流浪诗人
爱情抗体	爱情抗体
回来的大酱汤锅	回来的大酱汤锅
游龙戏凤	游龙戏凤
风流少年唐伯虎	风流少年唐伯虎
海狼行动	海狼行动
少林小子	少林小子
其实	其实
逃学威龙2	逃学威龙2
此恨绵绵无绝期	此恨绵绵无绝期
兵哥哥	兵哥哥
霓虹灯下的哨兵	霓虹灯下的哨兵
日不落	日不落
爱你一万年	爱你一万年
红色高跟鞋	红色高跟鞋
一定	一定
微加幸福	微加幸福
乾隆王朝	乾隆王朝
亲近我资源类型	亲近我资源类型
摇滚夏令营	摇滚夏令营
苏州河	苏州河
新虎口遐想	新虎口遐想
无间道	无间道
暮光之城：新月	暮光之城：新月
魂归鲤鱼溪	魂归鲤鱼溪
随风而逝	随风而逝
苏州夜曲	苏州夜曲
外滩警事	外滩警事
心灵驿站	心灵驿站
high歌	high歌
明天你好	明天你好
私立马鹿兰高校	私立马鹿兰高校
爱斯基摩	爱斯基摩
重案组	重案组
伤心城市	伤心城市
小资女孩向前冲	小资女孩向前冲
倾国之恋	倾国之恋
傻儿司令	傻儿司令
后菜鸟的灿烂时代	后菜鸟的灿烂时代
风雨丽人	风雨丽人
冰棍	冰棍
群龙戏凤	群龙戏凤
大祭桩	大祭桩
等爱归来	等爱归来
信心旅行	信心旅行
蜘蛛侠3	蜘蛛侠3
美味的想念	美味的想念
八路军	八路军
天天饮食	天天饮食
转世惊情	转世惊情
埃尔文·约翰逊	埃尔文·约翰逊
长假	长假
稻草人之恋	稻草人之恋
男人都那样	男人都那样
祝福妈妈	祝福妈妈
三滴血	三滴血
大海啊，故乡	大海啊，故乡
谋杀绿脚趾	谋杀绿脚趾
说好各走五十步	说好各走五十步
太平天国	太平天国
侦探学园Q	侦探学园Q
巾帼枭雄之义海豪情	巾帼枭雄之义海豪情
不要爱情了	不要爱情了
勇往直前	勇往直前
运河谣	运河谣
恐怖照相机	恐怖照相机
边沿	边沿
OREA	OREA
龙之舞	龙之舞
分开以后	分开以后
24小时也不够	24小时也不够
来生泪	来生泪
锁五龙	锁五龙
心灵牧场	心灵牧场
痛也没关系	痛也没关系
帮帮我爱神	帮帮我爱神
心机母女	心机母女
蝴蝶花	蝴蝶花
海誓山盟	海誓山盟
空谷兰	空谷兰
了不起的挑战	了不起的挑战
恋夏38℃	恋夏38℃
人体探险队	人体探险队
真情	真情
starman~这个星球上的恋爱	starman~这个星球上的恋爱
布鲁克	布鲁克
梦想前行	梦想前行
密电风云	密电风云
换心	换心
战地情天	战地情天
黄河绝恋	黄河绝恋
父辈的旗帜	父辈的旗帜
铁梨花	铁梨花
对嘴	对嘴
圣诞	圣诞
真·飞鸟	真·飞鸟
真田丸	真田丸
入殓师	入殓师
与狼共舞	与狼共舞
我们的小世界	我们的小世界
奇幻精品店	奇幻精品店
官不住的声音	官不住的声音
守护天使	守护天使
再见火锅	再见火锅
我在那一角落患过伤风	我在那一角落患过伤风
Gentleman	Gentleman
金装四大才子	金装四大才子
你来自哪颗星	你来自哪颗星
紫钗奇缘	紫钗奇缘
搏击迷城	搏击迷城
乐作人生	乐作人生
棒球伙伴	棒球伙伴
傻孩子	傻孩子
一代女皇武则天	一代女皇武则天
误以为爱情	误以为爱情
没有冬天的海岛	没有冬天的海岛
王华	王华
牛仔裤的夏天	牛仔裤的夏天
爱，很美	爱，很美
猎天狼	猎天狼
真爱100天	真爱100天
新桥恋人	新桥恋人
想吃麻花现给你拧	想吃麻花现给你拧
名媛望族	名媛望族
我那呼兰河	我那呼兰河
销魂玉	销魂玉
哭不出来	哭不出来
三毛流浪记	三毛流浪记
菠萝菠萝蜜	菠萝菠萝蜜
阳光姐妹淘	阳光姐妹淘
发钱寒	发钱寒
美丽在望	美丽在望
迷雾	迷雾
尖刀队	尖刀队
刑警队长	刑警队长
突围突围	突围突围
夏日狂奔	夏日狂奔
传说的拳头	传说的拳头
特兰克斯	特兰克斯
星海	星海
打面缸	打面缸
百分百女孩	百分百女孩
我的兄弟叫顺溜	我的兄弟叫顺溜
今天	今天
You're Beautiful	You're Beautiful
我叫金三顺	我叫金三顺
还珠格格之燕儿翩翩飞	还珠格格之燕儿翩翩飞
非常主播	非常主播
没关系，爸爸的女儿	没关系，爸爸的女儿
湘南暴走族	湘南暴走族
克莱德	克莱德
I Remember	I Remember
怎么唱情歌	怎么唱情歌
谁懂女儿心	谁懂女儿心
狂飙支队	狂飙支队
输人不输阵	输人不输阵
快乐大本营	快乐大本营
猜火车	猜火车
校园童声	校园童声
恋爱禁止条例	恋爱禁止条例
爱你所以离开你	爱你所以离开你
浪费	浪费
妻子	妻子
到爱的距离	到爱的距离
下海	下海
最好的我们	最好的我们
悲悼	悲悼
夺帅	夺帅
Heartbreak Hotel	Heartbreak Hotel
惊蛰	惊蛰
我是山姆	我是山姆
金色农家	金色农家
勇敢做自己	勇敢做自己
红衫泪痕	红衫泪痕
怀念过去	怀念过去
美版生人勿进	美版生人勿进
雪白血红	雪白血红
两妻时代	两妻时代
坡州	坡州
父女七日变	父女七日变
想你想疯了	想你想疯了
女人漫画皮鞋	女人漫画皮鞋
大酒店	大酒店
大转折	大转折
不善良的女人们	不善良的女人们
If We Ever Meet Again	If We Ever Meet Again
这个夏天有异性	这个夏天有异性
恶人	恶人
校阅女孩河野悦子	校阅女孩河野悦子
马龙·白兰度传	马龙·白兰度传
伊卡洛斯	伊卡洛斯
姊妹	姊妹
大魔术师	大魔术师
超级小郎中	超级小郎中
爱你无条件	爱你无条件
红旗漫卷西风	红旗漫卷西风
没有男人的女人	没有男人的女人
三十岁，你好	三十岁，你好
郎在远方	郎在远方
五瓣之椿	五瓣之椿
假面教师	假面教师
王子的新衣	王子的新衣
秀逗小护士3	秀逗小护士3
知青	知青
特战先锋	特战先锋
一帘幽梦	一帘幽梦
黑社会	黑社会
别叫我兄弟	别叫我兄弟
王子变青蛙	王子变青蛙
烈火金刚	烈火金刚
越来越好	越来越好
蛇王子	蛇王子
天雨花	天雨花
真爱黑白配	真爱黑白配
靓仔	靓仔
第三军团	第三军团
中华丈夫	中华丈夫
我怕恋爱	我怕恋爱
鸫诚士郎	鸫诚士郎
雨夜	雨夜
被遗弃的秘密	被遗弃的秘密
仁心解码Ⅱ	仁心解码Ⅱ
full moon	full moon
爱得太多	爱得太多
催眠大师	催眠大师
推销员之死	推销员之死
乘龙怪婿	乘龙怪婿
心动舞台	心动舞台
吸血鬼猎人巴菲	吸血鬼猎人巴菲
犯罪现场调查	犯罪现场调查
伯乐	伯乐
读心神探	读心神探
相亲2	相亲2
都市118美女试睡员	都市118美女试睡员
忘记我是谁	忘记我是谁
寻找爱的冒险	寻找爱的冒险
一门英烈穆桂英	一门英烈穆桂英
欲望人生	欲望人生
卖火柴的女孩再生	卖火柴的女孩再生
新聊斋志异	新聊斋志异
捉妖记	捉妖记
没关系，是爱情啊	没关系，是爱情啊
潇洒小姐	潇洒小姐
最后的贵族	最后的贵族
天才白痴梦	天才白痴梦
心魔	心魔
眼泪笑了	眼泪笑了
波特卡斯·D·艾斯	波特卡斯·D·艾斯
牧人之子	牧人之子
李香兰	李香兰
走开	走开
民生	民生
胡桃夹子	胡桃夹子
我是男神	我是男神
张三的歌	张三的歌
粗暴与待机	粗暴与待机
丹羽大助	丹羽大助
大家族	大家族
绝对隐私	绝对隐私
大爱无敌	大爱无敌
赤子	赤子
千里雷声万里闪	千里雷声万里闪
全凭我	全凭我
crayon	crayon
老父亲	老父亲
在悉尼等我	在悉尼等我
你不再爱我	你不再爱我
七剑	七剑
会过去的	会过去的
使命召唤	使命召唤
狂想曲	狂想曲
还珠格格	还珠格格
避风港	避风港
crazy in love	crazy in love
硫磺岛家书	硫磺岛家书
北京攻略	北京攻略
因为爱所以爱	因为爱所以爱
金陵十三钗	金陵十三钗
盛夏的果实	盛夏的果实
还好有你在	还好有你在
光环之后	光环之后
famous	famous
古曼	古曼
Jump Up	Jump Up
孤注一掷	孤注一掷
梨园春	梨园春
金科长	金科长
no one	no one
团团圆圆	团团圆圆
好好说再见	好好说再见
虎山行	虎山行
因为是第一次	因为是第一次
徐浩Xiho	徐浩Xiho
午间新闻	午间新闻
喋血黑谷	喋血黑谷
两只小蜜蜂	两只小蜜蜂
暴走吧，女人	暴走吧，女人
网络	网络
师奶强人	师奶强人
霹雳游侠	霹雳游侠
江山	江山
新昨夜星辰	新昨夜星辰
Waiting Outside The Lines	Waiting Outside The Lines
南夏奈	南夏奈
邻家英雄	邻家英雄
崇拜	崇拜
疑惑边缘	疑惑边缘
吉赛尔	吉赛尔
特洛伊	特洛伊
最幸福的事	最幸福的事
天使之城	天使之城
独照	独照
马粥街残酷史	马粥街残酷史
柠檬甜甜的	柠檬甜甜的
沉静的旋律	沉静的旋律
登陆之日	登陆之日
成均馆绯闻	成均馆绯闻
村官过大年	村官过大年
遗产五亿圆	遗产五亿圆
拉洋片	拉洋片
神探狄仁杰	神探狄仁杰
按下电钮那一刻	按下电钮那一刻
I Believe	I Believe
盲井	盲井
生活永远沸腾	生活永远沸腾
Fighter	Fighter
甜蜜蜜	甜蜜蜜
侏罗纪公园	侏罗纪公园
我最亲爱的	我最亲爱的
妈妈无罪	妈妈无罪
家有喜妇	家有喜妇
花神咖啡馆	花神咖啡馆
你身在何方	你身在何方
英雄赞歌	英雄赞歌
青城山下白素贞	青城山下白素贞
圣天门口	圣天门口
木户蕾	木户蕾
老无所依	老无所依
谁是儿子	谁是儿子
黎明	黎明
上海	上海
盗贼同盟	盗贼同盟
百年情书	百年情书
狠狠爱	狠狠爱
十年	十年
如果没有你的爱	如果没有你的爱
终结者2：审判日	终结者2：审判日
开心辞典	开心辞典
少女潘金莲	少女潘金莲
无意冒犯	无意冒犯
冲线	冲线
王海涛今年41	王海涛今年41
红衣坊	红衣坊
乱世佳人	乱世佳人
傀儡人生	傀儡人生
娱乐百分百	娱乐百分百
足球尤物	足球尤物
太早	太早
侨乐融融	侨乐融融
咕咕是只猫	咕咕是只猫
让我欢喜让我忧	让我欢喜让我忧
大震撼	大震撼
长门有希	长门有希
熊猫来了	熊猫来了
拥抱季节	拥抱季节
超兽机神断空我	超兽机神断空我
倔强萝卜	倔强萝卜
爱似水仙	爱似水仙
清须会议	清须会议
终极三国	终极三国
大宅门1912	大宅门1912
艺术家的生涯	艺术家的生涯
飞天舞	飞天舞
狮子王	狮子王
卫生队的故事	卫生队的故事
冬日惊雷	冬日惊雷
福星高照	福星高照
暗金丑岛君	暗金丑岛君
天后	天后
我最喜欢你	我最喜欢你
蜜桃成熟时	蜜桃成熟时
慈母曲	慈母曲
锣鼓巷	锣鼓巷
苏六娘	苏六娘
不是说好的吗	不是说好的吗
纳尼亚传奇：黎明踏浪号	纳尼亚传奇：黎明踏浪号
皮囊	皮囊
黑糖群侠传	黑糖群侠传
形影不离	形影不离
龙珠	龙珠
高木涉	高木涉
今日的5年2班	今日的5年2班
其实我不快乐	其实我不快乐
请叫我女王陛下	请叫我女王陛下
命中注定我爱你	命中注定我爱你
民王	民王
斗鱼	斗鱼
七友	七友
带你潇洒带你嗨	带你潇洒带你嗨
一星龙	一星龙
旅行者	旅行者
卑劣的街头	卑劣的街头
钱多多炼爱记	钱多多炼爱记
我不是男神	我不是男神
沉默与谎言	沉默与谎言
把爱带回家	把爱带回家
曾宝珠	曾宝珠
疼爱妈妈	疼爱妈妈
再见西雅图	再见西雅图
女人的青春	女人的青春
军中乐园	军中乐园
德艺双馨	德艺双馨
风间彻	风间彻
笛子魔童	笛子魔童
有你陪着我	有你陪着我
开罗时间	开罗时间
失恋33天	失恋33天
奸人坚	奸人坚
铁道游击队	铁道游击队
知音	知音
don't know why	don't know why
初恋风暴	初恋风暴
It's Hyorish	It's Hyorish
爱全为你	爱全为你
爱的礼物	爱的礼物
总务二科	总务二科
爱情三贱客	爱情三贱客
国家密码	国家密码
庐山恋	庐山恋
懂你	懂你
幕后玩家	幕后玩家
李世民	李世民
七小福	七小福
花样女人	花样女人
惊天危机	惊天危机
转身	转身
老城墙	老城墙
不良情侣	不良情侣
花树下的约定	花树下的约定
葡萄园的那小伙儿	葡萄园的那小伙儿
思凡	思凡
农家乐	农家乐
家有仙妻	家有仙妻
开棺	开棺
九品芝麻官之白面包青天	九品芝麻官之白面包青天
刁蛮俏御医	刁蛮俏御医
激流之战	激流之战
变HEN	变HEN
白色婚礼	白色婚礼
双面胶	双面胶
梦幻天使	梦幻天使
那个女人	那个女人
姬路瑞希	姬路瑞希
有房别出租	有房别出租
幸福万年长	幸福万年长
斯琴高丽	斯琴高丽
孽海花	孽海花
霹雳mit	霹雳mit
雪娘	雪娘
那年夏天	那年夏天
姑娘爱情郎	姑娘爱情郎
轩辕剑之天之痕	轩辕剑之天之痕
七月流火	七月流火
爱就爱了	爱就爱了
停不了的爱	停不了的爱
却上心头	却上心头
我的1997	我的1997
人说山西好风光	人说山西好风光
刀客家族的女人	刀客家族的女人
天下父母心	天下父母心
开开心心快快乐乐	开开心心快快乐乐
妈妈像花儿一样	妈妈像花儿一样
爱的城堡	爱的城堡
决战江南	决战江南
红白歌会	红白歌会
真城最高	真城最高
呼吸	呼吸
夜夜夜夜	夜夜夜夜
英雄	英雄
big波诱惑	big波诱惑
喜莲	喜莲
爱在日出前	爱在日出前
圈内圈外	圈内圈外
小合唱	小合唱
007：大战皇家赌场	007：大战皇家赌场
定春	定春
signal	signal
麻辣教师GTO	麻辣教师GTO
匆匆那年	匆匆那年
霸王别姬	霸王别姬
孤独的美食家第二季	孤独的美食家第二季
长城	长城
通天干探	通天干探
老妈的三国时代	老妈的三国时代
邓小平·1928	邓小平·1928
风尘三侠	风尘三侠
新乱世佳人	新乱世佳人
收规华	收规华
幸福的餐桌	幸福的餐桌
历史的使命	历史的使命
敢死队3	敢死队3
神探狄仁杰之情花金人案	神探狄仁杰之情花金人案
大路上	大路上
聪明小空空	聪明小空空
只恨自己爱错你	只恨自己爱错你
疑情别恋	疑情别恋
七公主	七公主
分手后还可以做朋友	分手后还可以做朋友
美咲NO.1	美咲NO.1
身在高地	身在高地
我爱台妹	我爱台妹
危险小天使	危险小天使
私人订制	私人订制
高校教师	高校教师
柳月弯弯	柳月弯弯
报春花	报春花
总理和我	总理和我
虎口拔牙	虎口拔牙
泪洒尘缘	泪洒尘缘
向日葵	向日葵
落地，请开手机	落地，请开手机
属于你的我的初恋	属于你的我的初恋
不可挽回	不可挽回
大明王朝1449	大明王朝1449
情愿放手	情愿放手
远远的爱	远远的爱
喜福会	喜福会
哪吒与杨戬	哪吒与杨戬
父子神探之龙抬头	父子神探之龙抬头
不爱了也是一种爱	不爱了也是一种爱
观音阁	观音阁
我是李小龙	我是李小龙
狂野的爱	狂野的爱
18岁的约定	18岁的约定
戒不掉	戒不掉
深夜医院	深夜医院
贵夫人	贵夫人
四十岁的老处男	四十岁的老处男
春宵曲	春宵曲
K歌之王	K歌之王
埃及艳后般的女人们	埃及艳后般的女人们
幻城	幻城
喜欢	喜欢
消息	消息
幸福的面条	幸福的面条
帝国的早晨	帝国的早晨
铁拳浪子	铁拳浪子
假面骑士555	假面骑士555
silence	silence
誓言无声	誓言无声
卫少芳	卫少芳
再见理想	再见理想
圣保罗号炮艇	圣保罗号炮艇
美梦成真	美梦成真
不要和陌生人说话	不要和陌生人说话
谎言的诞生	谎言的诞生
天使心	天使心
爱情面前谁怕谁	爱情面前谁怕谁
南极大冒险	南极大冒险
纯真年代	纯真年代
在云端	在云端
等待	等待
蝴蝶翩翩飞	蝴蝶翩翩飞
我想有个家	我想有个家
荣光	荣光
梅艳芳菲	梅艳芳菲
广岛之恋	广岛之恋
杨光的快乐生活4	杨光的快乐生活4
将相和	将相和
Get it hot	Get it hot
不求上进的玉子	不求上进的玉子
死了都要爱	死了都要爱
龙在江湖	龙在江湖
新萍踪侠影	新萍踪侠影
帝锦	帝锦
别动我的抽屉	别动我的抽屉
济公之人皇鼎	济公之人皇鼎
独狼	独狼
我是怎么了	我是怎么了
壬生义士传	壬生义士传
万能钥匙	万能钥匙
不允许哭泣的场合	不允许哭泣的场合
拉斯维加斯	拉斯维加斯
峰女壁女	峰女壁女
家有六子	家有六子
绝对计划	绝对计划
新仙鹤神针	新仙鹤神针
同手同脚	同手同脚
不道德的礼物	不道德的礼物
石敢当之雄峙天东	石敢当之雄峙天东
练习题	练习题
王力宏	王力宏
Polyrhythm	Polyrhythm
快乐不快乐	快乐不快乐
愚人码头	愚人码头
天使之吻	天使之吻
诱狼	诱狼
海云台	海云台
心痛2009	心痛2009
妈妈姐姐	妈妈姐姐
爱情风暴美丽99	爱情风暴美丽99
梦的翅膀受了伤	梦的翅膀受了伤
他不爱我	他不爱我
黑暗的另一半	黑暗的另一半
暖心	暖心
黑帮高中	黑帮高中
哈克奥罗	哈克奥罗
少年林祥谦	少年林祥谦
平凡的幸福	平凡的幸福
一代皇后大玉儿	一代皇后大玉儿
家春秋	家春秋
八扇屏	八扇屏
少年神探狄仁杰	少年神探狄仁杰
火腿，火腿	火腿，火腿
追踪眼前人	追踪眼前人
开心宝贝	开心宝贝
走到尽头	走到尽头
镜音连	镜音连
百子千孙	百子千孙
王子看见二公主	王子看见二公主
疯狂寻爱记	疯狂寻爱记
孔子	孔子
隔离七日情	隔离七日情
镜花缘OL	镜花缘OL
无懈可击	无懈可击
心肝大宝贝	心肝大宝贝
周璇	周璇
格萨尔	格萨尔
Bye Bye Disco	Bye Bye Disco
密战	密战
狼吻夜惊魂	狼吻夜惊魂
老农民	老农民
欢喜来逗阵	欢喜来逗阵
银河	银河
赤焰战场	赤焰战场
万有引力	万有引力
黑道风云	黑道风云
年轮说	年轮说
厨缘	厨缘
挣扎	挣扎
年度之歌	年度之歌
难忘的战斗	难忘的战斗
黄河大侠	黄河大侠
因父之名	因父之名
我的女孩	我的女孩
刑警使命	刑警使命
狼兵吼	狼兵吼
圣母在上	圣母在上
通讯卫星	通讯卫星
旅程	旅程
大叔，我爱你	大叔，我爱你
非常幸运	非常幸运
天使与魔鬼	天使与魔鬼
爱在星光灿烂时	爱在星光灿烂时
晓风残月	晓风残月
偶滴歌神啊	偶滴歌神啊
马可·波罗	马可·波罗
特种部队	特种部队
合影留念	合影留念
参工传奇	参工传奇
电车少女	电车少女
西行漫记	西行漫记
拆局专家	拆局专家
终于等到你	终于等到你
分手了还可以做朋友	分手了还可以做朋友
红旗下的蛋	红旗下的蛋
芸娘	芸娘
幸福要来到	幸福要来到
Hall Of Fame	Hall Of Fame
未成年	未成年
情同手足	情同手足
大国船梦	大国船梦
黑森林	黑森林
青春期3	青春期3
女刑警李春春	女刑警李春春
圈子	圈子
欢天喜地对亲家	欢天喜地对亲家
夏日乐悠悠	夏日乐悠悠
黄头发2	黄头发2
绝代商骄	绝代商骄
爱新觉罗·玄烨	爱新觉罗·玄烨
天国的孩子们	天国的孩子们
酒干倘卖无	酒干倘卖无
灯草和尚	灯草和尚
王妃	王妃
老家门口唱大戏	老家门口唱大戏
我们回不去了	我们回不去了
香草美人	香草美人
不死情谜	不死情谜
没事偷着乐	没事偷着乐
人在纽约	人在纽约
父子	父子
橘真琴	橘真琴
突击再突击	突击再突击
大和敢助	大和敢助
父子刑警	父子刑警
笑着活下去	笑着活下去
海上花	海上花
惦记	惦记
吴二哥请神	吴二哥请神
细雪	细雪
至尊无上	至尊无上
纽约纽约	纽约纽约
爱情万岁	爱情万岁
导盲犬小Q	导盲犬小Q
薛平贵与王宝钏	薛平贵与王宝钏
丽花皇宫	丽花皇宫
救姻缘	救姻缘
不走	不走
超时空救兵	超时空救兵
长大	长大
十个连长一个班	十个连长一个班
孤枕难眠	孤枕难眠
拳皇	拳皇
平淡生活	平淡生活
交响诗篇	交响诗篇
危险性游戏	危险性游戏
白虎堂	白虎堂
他们的船	他们的船
13岁的Hello Work	13岁的Hello Work
黑执事	黑执事
电影就是电影	电影就是电影
Pieng ter	Pieng ter
大树西迁	大树西迁
苏格拉没有底	苏格拉没有底
双核时代	双核时代
蜗居	蜗居
恋恋笔记本	恋恋笔记本
拉拉爱	拉拉爱
聊斋之秋月还阳	聊斋之秋月还阳
投奔怒海	投奔怒海
携手游人间	携手游人间
定军山	定军山
百万元和苦虫女	百万元和苦虫女
母鸡带小鸭	母鸡带小鸭
红旗颂	红旗颂
吻我，杀我	吻我，杀我
亮剑	亮剑
翡翠马	翡翠马
风之国	风之国
孟父三迁之教	孟父三迁之教
终极女郎	终极女郎
某年夏天	某年夏天
天狗	天狗
新都市人	新都市人
贫民百万歌星	贫民百万歌星
梦入桃花源	梦入桃花源
美甲店paris	美甲店paris
瘦身男女	瘦身男女
百年浮城	百年浮城
银行大劫案	银行大劫案
careless whisper	careless whisper
托斯卡	托斯卡
淘金年代	淘金年代
我爱李泰利	我爱李泰利
你一直都在	你一直都在
冷山	冷山
夏之雪	夏之雪
城市猎人	城市猎人
声音	声音
第二处女	第二处女
我的公主	我的公主
我的中国心	我的中国心
烟水寒	烟水寒
天鹅之死	天鹅之死
马向阳下乡记	马向阳下乡记
我想大声告诉你	我想大声告诉你
珠洲城遥	珠洲城遥
连升三级	连升三级
风雷动	风雷动
日照重庆	日照重庆
缺一不可	缺一不可
让爱回家吧	让爱回家吧
律政英雄	律政英雄
金色琴弦	金色琴弦
一半	一半
新选组	新选组
七条天空	七条天空
对面的女孩看过来	对面的女孩看过来
今宵多珍重	今宵多珍重
钢之炼金术师	钢之炼金术师
旗袍旗袍	旗袍旗袍
上海一家人	上海一家人
相爱十年	相爱十年
红布绿花朵	红布绿花朵
今天比昨天更	今天比昨天更
我的女友是机器人	我的女友是机器人
假如	假如
阴阳界	阴阳界
突发事件	突发事件
jumping girl	jumping girl
神勇双星	神勇双星
不离不弃	不离不弃
北极星的眼泪	北极星的眼泪
毕打自己人	毕打自己人
Mr.	Mr.
似水年华	似水年华
姥爷的抗战	姥爷的抗战
地心引力	地心引力
欢迎来到阴阳屋	欢迎来到阴阳屋
超凡蜘蛛侠	超凡蜘蛛侠
攀枝花	攀枝花
白发魔女传	白发魔女传
沾沾自喜	沾沾自喜
从现在开始爱你	从现在开始爱你
战北平	战北平
夜市人生	夜市人生
金色池塘	金色池塘
新洛神	新洛神
with love,j	with love,j
曾经我们痛爱过	曾经我们痛爱过
美味米饭	美味米饭
亚当斯一家	亚当斯一家
涩世纪传说	涩世纪传说
二楼的恶人	二楼的恶人
妈祖的传说	妈祖的传说
幽游白书	幽游白书
女高怪谈3：狐狸阶梯	女高怪谈3：狐狸阶梯
水手	水手
空气人	空气人
九江十二坊	九江十二坊
美丽心灵的永恒阳光	美丽心灵的永恒阳光
情歌没有告诉你	情歌没有告诉你
宾虚	宾虚
真爱永存	真爱永存
love song	love song
暖冬	暖冬
学警雄心	学警雄心
冬季恋歌	冬季恋歌
无心恋唱	无心恋唱
自作多情	自作多情
家族游戏	家族游戏
多远都要在一起	多远都要在一起
给我庇护	给我庇护
单身男女2	单身男女2
复仇者联盟	复仇者联盟
无声的雨丝	无声的雨丝
迹部景吾	迹部景吾
欺诈猎人	欺诈猎人
向天要一点爱	向天要一点爱
囧囧	囧囧
知心恋人	知心恋人
完美嫁衣	完美嫁衣
孤独的歌声	孤独的歌声
今生是亲人	今生是亲人
山楂树	山楂树
池田华菜	池田华菜
ROAR	ROAR
犬饲先生养狗记	犬饲先生养狗记
天定情缘	天定情缘
忍者刺客	忍者刺客
楚汉骄雄	楚汉骄雄
桃花期	桃花期
别和我谈高富帅	别和我谈高富帅
游	游
铁齿铜牙纪晓岚第肆部	铁齿铜牙纪晓岚第肆部
黑客帝国2：重装上阵	黑客帝国2：重装上阵
丑八怪警报	丑八怪警报
你好周杰伦	你好周杰伦
自由恋爱	自由恋爱
圈套	圈套
亲密	亲密
一直都爱你	一直都爱你
十日拍拖手册	十日拍拖手册
无处安放	无处安放
莞香	莞香
ONE MORE	ONE MORE
不想长大的孩子	不想长大的孩子
玫瑰人生	玫瑰人生
快乐星球1	快乐星球1
纸牌屋	纸牌屋
功夫之爱的速递	功夫之爱的速递
True Colors	True Colors
信长协奏曲	信长协奏曲
挖井人的女儿	挖井人的女儿
真正男子汉	真正男子汉
舞乐传奇	舞乐传奇
内地	内地
终极标靶	终极标靶
逆战	逆战
江湖论剑实录	江湖论剑实录
少年闵子骞	少年闵子骞
皇家反千组	皇家反千组
火玫瑰	火玫瑰
精武陈真	精武陈真
大红灯笼高高挂	大红灯笼高高挂
一见钟情	一见钟情
你的烂借口	你的烂借口
变相怪杰	变相怪杰
航班蛇患	航班蛇患
西游·降魔篇	西游·降魔篇
绞刑架下的春天	绞刑架下的春天
秋天1944	秋天1944
戆夫成龙	戆夫成龙
我要快乐？	我要快乐？
盲·道	盲·道
拷红	拷红
最佳爱情	最佳爱情
大地惊雷	大地惊雷
红旗飘飘	红旗飘飘
那时花开	那时花开
血脉	血脉
umbrella	umbrella
亲家过年	亲家过年
大侠霍元甲	大侠霍元甲
让一切随风	让一切随风
飞翔入手	飞翔入手
吸血鬼日记	吸血鬼日记
风继续吹	风继续吹
冷暖人间	冷暖人间
勇闯夺命岛	勇闯夺命岛
下一个炎亚纶	下一个炎亚纶
怒剑狂刀	怒剑狂刀
别开玩笑了！	别开玩笑了！
泪滴在琴上	泪滴在琴上
哎咿呀	哎咿呀
小小瑜的闹闹	小小瑜的闹闹
再见巨人	再见巨人
难得有情人	难得有情人
享受人生	享受人生
求偶一支公	求偶一支公
十二星座	十二星座
频率	频率
胜利之光	胜利之光
月亮河	月亮河
桃花灿烂	桃花灿烂
独立日	独立日
茶叶青	茶叶青
怒	怒
你呀你呀	你呀你呀
我们都是好孩子	我们都是好孩子
石义大战蠎蛇精	石义大战蠎蛇精
约会大作战	约会大作战
小菜一碟	小菜一碟
傻女神	傻女神
治外法权	治外法权
孔雀王子	孔雀王子
宫	宫
车在囧途	车在囧途
千日的约定	千日的约定
弗利萨	弗利萨
无懈可击之蓝色梦想	无懈可击之蓝色梦想
风华绝代	风华绝代
失孤	失孤
弹孔	弹孔
BOYFRIEND	BOYFRIEND
幽灵	幽灵
住在清潭洞	住在清潭洞
有闲俱乐部	有闲俱乐部
Smile Again	Smile Again
都市男女	都市男女
我被青春撞了一下腰	我被青春撞了一下腰
大地回春	大地回春
老有所依	老有所依
爱情ATM	爱情ATM
拆弹部队	拆弹部队
妖怪人间贝姆	妖怪人间贝姆
从你的全世界路过	从你的全世界路过
花环夫人	花环夫人
阳光像花儿一样绽放	阳光像花儿一样绽放
梦驼铃	梦驼铃
世界奇妙物语2012年春季特别篇	世界奇妙物语2012年春季特别篇
挂念	挂念
firework	firework
死侍	死侍
走过柳源	走过柳源
恋爱自由式	恋爱自由式
狂暴飞车	狂暴飞车
辉煌时代	辉煌时代
后天	后天
我的心肝宝贝	我的心肝宝贝
幸福百米	幸福百米
女朋友·男朋友	女朋友·男朋友
since u been gone	since u been gone
欢乐今宵	欢乐今宵
虫师	虫师
女神时代	女神时代
疯狂第一次	疯狂第一次
该死的温柔	该死的温柔
当爱已成往事	当爱已成往事
大声说爱我	大声说爱我
胡闹	胡闹
惊情	惊情
午夜心跳	午夜心跳
呛声	呛声
蓝沁传奇	蓝沁传奇
侠游云天	侠游云天
夏至未至	夏至未至
我是一片云	我是一片云
头七	头七
轻音少女	轻音少女
青蛇	青蛇
千方百计	千方百计
极乐空间	极乐空间
儿女的战争	儿女的战争
死囚漫步	死囚漫步
悲催姊妹篇	悲催姊妹篇
国士无双黄飞鸿	国士无双黄飞鸿
我心灿烂	我心灿烂
城中大盗	城中大盗
candyman	candyman
我是黑社会	我是黑社会
梁世英	梁世英
雷横与朱仝	雷横与朱仝
四个爱情故事	四个爱情故事
擦肩而过	擦肩而过
我主沉浮	我主沉浮
冬冬狗，狗冬冬	冬冬狗，狗冬冬
金瓯	金瓯
电司	电司
七级公务员	七级公务员
神偷谍影	神偷谍影
摩登俏冤家	摩登俏冤家
失去你的那一天	失去你的那一天
冲出亚马逊	冲出亚马逊
天下一家	天下一家
愤怒的小鸟	愤怒的小鸟
穿普拉达的女王	穿普拉达的女王
阿尔菲	阿尔菲
女王的教室	女王的教室
越看越撒娇满分	越看越撒娇满分
逼得宠物太紧	逼得宠物太紧
加加油大小姐	加加油大小姐
疯狂愚蠢的爱	疯狂愚蠢的爱
铃木先生	铃木先生
真命小和尚	真命小和尚
中国电视剧飞天奖	中国电视剧飞天奖
最初的梦想	最初的梦想
左眼诡事	左眼诡事
初恋50次	初恋50次
天下第一	天下第一
太阳的女人	太阳的女人
金钱天使	金钱天使
婚姻顾问	婚姻顾问
张楚	张楚
不如温柔的唱吧	不如温柔的唱吧
电动英雄	电动英雄
一马换三羊	一马换三羊
野蛮人	野蛮人
浅仓南	浅仓南
皇城根儿	皇城根儿
漂流教室	漂流教室
关胜	关胜
鸽之翼	鸽之翼
马尔柯姆的一家	马尔柯姆的一家
夏梦狂诗曲	夏梦狂诗曲
我们的荆轲	我们的荆轲
战昆仑	战昆仑
酒店风云	酒店风云
红磨坊	红磨坊
谁动了我的梦想	谁动了我的梦想
二缺一	二缺一
决不开枪	决不开枪
少林达摩	少林达摩
九指新娘	九指新娘
白色陷阱	白色陷阱
萧十一郎	萧十一郎
秀才遇着兵	秀才遇着兵
像火花像蝴蝶	像火花像蝴蝶
比天高比地厚	比天高比地厚
仁显王后的男人	仁显王后的男人
美翔舞	美翔舞
铁血兄弟	铁血兄弟
写乐保介	写乐保介
大城小子	大城小子
汉娜姐妹	汉娜姐妹
天师执位	天师执位
迎风而立的狮子	迎风而立的狮子
雷虎	雷虎
驴友阿凡提	驴友阿凡提
五花洞	五花洞
男神执事团	男神执事团
开心鬼系列	开心鬼系列
大校的女儿	大校的女儿
中南海保镖	中南海保镖
火炬手	火炬手
大国手	大国手
满堂爹娘	满堂爹娘
舒克和贝塔	舒克和贝塔
继续	继续
今天你要嫁给我	今天你要嫁给我
我是一只小小鸟	我是一只小小鸟
地狱为何恶劣	地狱为何恶劣
我们约会吧	我们约会吧
背心	背心
摩纳哥的格蕾丝	摩纳哥的格蕾丝
年年有今日	年年有今日
舞动青春	舞动青春
越王勾践	越王勾践
笔中情	笔中情
海霞	海霞
炎神战队轰音者	炎神战队轰音者
定制幸福	定制幸福
天下第二	天下第二
播报多看点	播报多看点
痞子遇到爱	痞子遇到爱
水浒传	水浒传
泡面的幸福	泡面的幸福
梦想剧场	梦想剧场
紫色大稻埕	紫色大稻埕
苏禄国王与中国皇帝	苏禄国王与中国皇帝
叶甫盖尼·奥涅金	叶甫盖尼·奥涅金
Till The World Ends	Till The World Ends
心有独钟	心有独钟
幻化成风	幻化成风
FLY ME TO THE MOON	FLY ME TO THE MOON
离开以后	离开以后
飞狐外传	飞狐外传
最后的圣诞节	最后的圣诞节
诉说	诉说
新僵尸先生	新僵尸先生
火花游戏	火花游戏
芳草碧连天	芳草碧连天
天生我才	天生我才
失恋事小	失恋事小
只有你	只有你
英雄泪	英雄泪
雪豹坚强岁月	雪豹坚强岁月
自虐之诗	自虐之诗
Low	Low
飞虎出征	飞虎出征
傲慢与偏见	傲慢与偏见
恶魔少爷别吻我	恶魔少爷别吻我
疯狂的玫瑰	疯狂的玫瑰
伟大的盖茨比	伟大的盖茨比
迷蝶香	迷蝶香
棒球英豪	棒球英豪
天真	天真
不懂女人	不懂女人
很爱很爱的	很爱很爱的
我们一定行	我们一定行
everything at once	everything at once
高地战	高地战
悄悄爱上你	悄悄爱上你
不是开玩笑	不是开玩笑
雅典娜	雅典娜
就算世界无童话	就算世界无童话
目标战	目标战
一个陌生女人的来信	一个陌生女人的来信
美女与虎	美女与虎
心理感应	心理感应
荣光的在仁	荣光的在仁
回到拉萨	回到拉萨
皇后大道东	皇后大道东
浴火凤凰	浴火凤凰
青春冲动	青春冲动
耶利亚女郎	耶利亚女郎
Your Body	Your Body
神断狄仁杰	神断狄仁杰
豪门	豪门
难兄难弟	难兄难弟
徐仁英的购物游戏in Singapore	徐仁英的购物游戏in Singapore
黄豆黄	黄豆黄
激战	激战
百变神偷	百变神偷
最后之良心	最后之良心
左半边翅膀	左半边翅膀
Limit界限	Limit界限
冲田总司	冲田总司
狄仁杰之神都龙王	狄仁杰之神都龙王
神魂颠倒	神魂颠倒
剧场逸事	剧场逸事
灵镜传奇	灵镜传奇
看月亮爬上来	看月亮爬上来
巾帼枭雄	巾帼枭雄
现代应召女郎	现代应召女郎
谈判冤家	谈判冤家
疯狂的赛车	疯狂的赛车
杀老师	杀老师
云海玉弓缘	云海玉弓缘
92黑玫瑰对黑玫瑰	92黑玫瑰对黑玫瑰
天堂之门	天堂之门
拳王	拳王
影子舞	影子舞
漂流欲室	漂流欲室
美丽家园	美丽家园
可疑的家族	可疑的家族
大野狼和小绵羊的爱情	大野狼和小绵羊的爱情
暗哨	暗哨
火鸟	火鸟
马拉松	马拉松
追追追	追追追
细细的红线	细细的红线
约书亚	约书亚
真心想让你幸福	真心想让你幸福
相爱的好日子	相爱的好日子
木之本樱	木之本樱
出嫁	出嫁
洛城三兄弟	洛城三兄弟
感情线	感情线
我们的少年时代	我们的少年时代
亲密关系	亲密关系
太阳公公	太阳公公
零零七	零零七
hold it against me	hold it against me
独行杀手	独行杀手
皇帝	皇帝
张小五的春天	张小五的春天
肥田喜事	肥田喜事
骇战	骇战
一句顶一万句	一句顶一万句
诱拐报道	诱拐报道
古刹钟声	古刹钟声
周瑜归天	周瑜归天
阿娣	阿娣
Wake me up	Wake me up
九五至尊	九五至尊
恋爱三万英尺	恋爱三万英尺
城寨英雄	城寨英雄
i	i
孤军英雄	孤军英雄
没有名字的甜点店	没有名字的甜点店
我是如此爱你	我是如此爱你
天地英雄	天地英雄
莱姆酒日记	莱姆酒日记
弗兰	弗兰
狙击生死线	狙击生死线
从前以后	从前以后
我以为	我以为
我要幸福	我要幸福
浮世恋曲	浮世恋曲
妙女神探	妙女神探
七子之歌	七子之歌
神的测验4	神的测验4
密道追踪之阴兵虎符	密道追踪之阴兵虎符
天空之城	天空之城
稻草之盾	稻草之盾
学园救援团	学园救援团
我要去红河	我要去红河
铁血使命	铁血使命
神犬奇兵	神犬奇兵
可惜没如果	可惜没如果
玉簪记	玉簪记
巴啦啦小魔仙之魔法的考验	巴啦啦小魔仙之魔法的考验
无极	无极
兰陵王	兰陵王
超时空要塞7	超时空要塞7
九层妖塔	九层妖塔
少女妙探	少女妙探
上班族金太郎	上班族金太郎
春琴传	春琴传
开心家族	开心家族
诡打墙	诡打墙
长征	长征
薛丁山	薛丁山
父爱如山	父爱如山
海神号	海神号
fate	fate
苦儿流浪记	苦儿流浪记
哭过就好了	哭过就好了
小查与寇弟的顶级生活	小查与寇弟的顶级生活
好不好	好不好
天蚕变	天蚕变
keroro军曹	keroro军曹
花火	花火
女人的力量	女人的力量
好女十八嫁	好女十八嫁
心雨	心雨
新鸳鸯蝴蝶梦	新鸳鸯蝴蝶梦
食神之路	食神之路
谍战锦屏山	谍战锦屏山
义不容情	义不容情
太阳最红	太阳最红
迎春的故事	迎春的故事
别问我是谁	别问我是谁
我有爱人了	我有爱人了
我在存在	我在存在
租个女友回家过年	租个女友回家过年
爱上你这样的女人	爱上你这样的女人
童年往事	童年往事
情乖乖	情乖乖
到底爱怎么了	到底爱怎么了
梦醒时分	梦醒时分
银翼杀手	银翼杀手
六福喜事	六福喜事
十二国记	十二国记
龙虎山客栈	龙虎山客栈
骄傲的火焰	骄傲的火焰
贝吉塔	贝吉塔
巫山风雨夜	巫山风雨夜
我家是战国	我家是战国
如朕亲临	如朕亲临
蔷薇少女	蔷薇少女
音乐风云榜	音乐风云榜
法证先锋	法证先锋
含泪跳恰恰	含泪跳恰恰
女人进城	女人进城
赫萝	赫萝
星愿	星愿
肝脏大夫	肝脏大夫
夜曲	夜曲
仙剑云之凡	仙剑云之凡
鹊桥兄弟们	鹊桥兄弟们
摘星之旅	摘星之旅
山歌好比春江水	山歌好比春江水
不良仔与眼镜妹	不良仔与眼镜妹
生死钟声	生死钟声
爱嫁不嫁	爱嫁不嫁
宝贝去哪儿	宝贝去哪儿
交响情人梦	交响情人梦
巴士站	巴士站
企鹅爸爸	企鹅爸爸
算什么	算什么
花样男子	花样男子
剑蝶	剑蝶
怕爱	怕爱
耀眼的日子	耀眼的日子
青春进行时	青春进行时
岁月神偷	岁月神偷
晚安亲爱的	晚安亲爱的
明若晓溪	明若晓溪
陕北牧歌	陕北牧歌
都是寂寞犯的错	都是寂寞犯的错
我是郭美美	我是郭美美
希望的田野	希望的田野
将爱情进行到底	将爱情进行到底
云上的诱惑	云上的诱惑
月夜姬	月夜姬
三毛从军记	三毛从军记
13岁的情人	13岁的情人
情谜睡美人	情谜睡美人
原来是你	原来是你
美丽曼特宁	美丽曼特宁
工藤优作	工藤优作
我11	我11
如果云知道	如果云知道
金色珊顿道	金色珊顿道
精卫填海	精卫填海
爱情，向左我向右	爱情，向左我向右
愚爱	愚爱
一百万	一百万
乡下人	乡下人
滚滚红尘	滚滚红尘
下町火箭	下町火箭
上古情歌	上古情歌
精灵宝可梦	精灵宝可梦
独立	独立
格格的女儿	格格的女儿
看见恶魔	看见恶魔
小英雄	小英雄
向北方	向北方
别让爱你的人等太久	别让爱你的人等太久
缉毒精英	缉毒精英
同桌计划	同桌计划
九回时间旅行	九回时间旅行
侦探成旭之龙城岁月	侦探成旭之龙城岁月
做次有钱人	做次有钱人
一路格桑花	一路格桑花
离经叛道	离经叛道
惊爆内幕	惊爆内幕
蝶变	蝶变
好汉两个半	好汉两个半
Vocalist	Vocalist
神奇侠侣	神奇侠侣
孤儿救祖记	孤儿救祖记
笙歌	笙歌
唐宫燕	唐宫燕
最美	最美
烙印勇士	烙印勇士
我的秘密花园	我的秘密花园
林黛玉没有眼泪	林黛玉没有眼泪
鱿鱼和鲸	鱿鱼和鲸
虎踞龙盘	虎踞龙盘
未婚妻	未婚妻
W-两个世界	W-两个世界
地久天长	地久天长
莫忘空城	莫忘空城
樱花大战	樱花大战
蓝天花朵	蓝天花朵
夏天协奏曲	夏天协奏曲
桃花扇	桃花扇
trouble is a friend	trouble is a friend
来者摩羯	来者摩羯
生命因你而动听	生命因你而动听
少年壮志不言愁	少年壮志不言愁
你是我兄弟	你是我兄弟
幸福三颗星	幸福三颗星
北京一夜	北京一夜
霜花店	霜花店
媛来是你	媛来是你
我的梦	我的梦
日奈森亚梦	日奈森亚梦
一程山水一程歌	一程山水一程歌
吕布与貂蝉	吕布与貂蝉
老大的幸福	老大的幸福
雍正王朝	雍正王朝
侍战队真剑者	侍战队真剑者
侠女	侠女
Don't cry	Don't cry
炮制女朋友	炮制女朋友
歌舞青春	歌舞青春
火原和树	火原和树
儿女冤家	儿女冤家
海上丝路	海上丝路
危机边缘	危机边缘
临沧的诱惑	临沧的诱惑
恩爱夫妻	恩爱夫妻
手机搜查官	手机搜查官
我不是坏女孩	我不是坏女孩
爱的世界	爱的世界
无间道Ⅱ	无间道Ⅱ
另一种灿烂生活	另一种灿烂生活
谁可改变	谁可改变
北战场精忠录	北战场精忠录
男人上路	男人上路
Be Mine	Be Mine
一生何求	一生何求
粤讲越掂	粤讲越掂
I Knew You Were Trouble.	I Knew You Were Trouble.
秘密花园	秘密花园
祥林嫂	祥林嫂
听到传闻	听到传闻
武士弗拉明戈	武士弗拉明戈
生命街车	生命街车
晨曲	晨曲
爱就宅一起	爱就宅一起
贫富人生	贫富人生
扶桑花女孩	扶桑花女孩
婴灵恶泣	婴灵恶泣
冰川时代	冰川时代
stan	stan
血色浪漫	血色浪漫
为你钟情	为你钟情
风月	风月
魔法灰姑娘	魔法灰姑娘
网中人	网中人
宰相刘罗锅	宰相刘罗锅
美丽人生	美丽人生
川军团血战到底	川军团血战到底
On Call 36小时Ⅱ	On Call 36小时Ⅱ
小鸡快跑	小鸡快跑
疯狂原始人	疯狂原始人
七妹	七妹
重译	重译
冬至	冬至
心理测量者	心理测量者
生死十日	生死十日
Healer	Healer
夜生活的女人	夜生活的女人
大牌对王牌	大牌对王牌
人道	人道
左维明巧断无头案	左维明巧断无头案
牵纸鹞的手	牵纸鹞的手
守爱	守爱
千万次的问	千万次的问
我的男人	我的男人
那些花儿	那些花儿
20岁的眼泪	20岁的眼泪
十八岁的天空	十八岁的天空
Sun With Love	Sun With Love
极限	极限
渺渺	渺渺
上古传说	上古传说
女总裁的贴身高手	女总裁的贴身高手
银魂	银魂
一个人生活	一个人生活
进击的巨人	进击的巨人
大河儿女	大河儿女
小兵张嘎	小兵张嘎
失婚男女	失婚男女
涟漪	涟漪
美味情缘	美味情缘
我的野蛮女友	我的野蛮女友
原地踏步	原地踏步
温柔的谎言	温柔的谎言
大屋的丫环们	大屋的丫环们
国崎往人	国崎往人
大叔的爱	大叔的爱
Daughtry	Daughtry
东成西就2011	东成西就2011
眼睛到地面的距离	眼睛到地面的距离
永不言弃	永不言弃
夏日甜心	夏日甜心
龙纹身的女孩	龙纹身的女孩
THE RED	THE RED
阳光丽人	阳光丽人
郎是春日风	郎是春日风
身骑白马	身骑白马
单亲房子	单亲房子
大理公主	大理公主
心痛的滋味	心痛的滋味
犀利仁师	犀利仁师
听着情歌流眼泪	听着情歌流眼泪
商道	商道
民国往事	民国往事
赵钱孙李	赵钱孙李
no.1	no.1
稻香	稻香
三国演义	三国演义
美女的诞生	美女的诞生
妻子和女人	妻子和女人
亿万克拉的幸福	亿万克拉的幸福
红河谷	红河谷
红土地	红土地
郭凤女	郭凤女
黑糖来了	黑糖来了
篮球部落	篮球部落
唯一的选择	唯一的选择
铁在烧	铁在烧
光能使者	光能使者
do you remember	do you remember
抬头不见低头见	抬头不见低头见
秋菊打官司	秋菊打官司
冷弦多情	冷弦多情
死之咏赞	死之咏赞
梅林传奇	梅林传奇
三世缘	三世缘
最最遥远的路	最最遥远的路
拒绝融化的冰	拒绝融化的冰
勇者义彦和魔王之城	勇者义彦和魔王之城
疯掉	疯掉
盛夏光年	盛夏光年
千钧一发	千钧一发
心情好的日子	心情好的日子
麻辣鲜师	麻辣鲜师
巨轮	巨轮
好朋友们	好朋友们
First Message	First Message
垃圾场	垃圾场
御统百合香	御统百合香
飞虎队	飞虎队
末班车	末班车
追击者	追击者
圣斗士星矢	圣斗士星矢
天下第一楼	天下第一楼
fate/stay night	fate/stay night
风一样的男子	风一样的男子
对我说谎试试	对我说谎试试
医心无悔	医心无悔
谷穗黄了	谷穗黄了
大学生了没	大学生了没
亲爱的，回家	亲爱的，回家
新神探联盟	新神探联盟
黑三角	黑三角
fantastic	fantastic
江城夏日	江城夏日
恋恋不忘	恋恋不忘
Rolling in the deep	Rolling in the deep
火把	火把
蜡笔小新	蜡笔小新
无用的我看见了天	无用的我看见了天
大小爱吃	大小爱吃
申东熙	申东熙
绿蔷薇	绿蔷薇
天国的邮递员	天国的邮递员
一起做吧	一起做吧
克利奥帕特拉七世	克利奥帕特拉七世
永远的朋友	永远的朋友
暂时的男朋友	暂时的男朋友
千里姻缘兜错圈	千里姻缘兜错圈
幸福等待	幸福等待
大秧歌	大秧歌
重生	重生
何必再拖	何必再拖
abcd said	abcd said
金刚狼	金刚狼
残梦	残梦
白色	白色
顿号	顿号
香港姊妹	香港姊妹
音痴诊所	音痴诊所
短发	短发
八大锤	八大锤
甜蜜间谍	甜蜜间谍
草燃	草燃
画出彩虹	画出彩虹
露西·哈特菲利亚	露西·哈特菲利亚
爱上哥们	爱上哥们
尸城	尸城
面包王金卓求	面包王金卓求
李贝拉的冬天	李贝拉的冬天
球爱俏佳人	球爱俏佳人
有你才幸福	有你才幸福
thank you	thank you
萌学园4：时空战役	萌学园4：时空战役
蒙娜丽莎的微笑	蒙娜丽莎的微笑
野原广志	野原广志
热气球	热气球
嘉油站	嘉油站
流氓律师	流氓律师
铁道卫士	铁道卫士
濑户的花嫁	濑户的花嫁
思念探戈	思念探戈
食神	食神
生死攸关话名牌	生死攸关话名牌
立春	立春
越难越爱	越难越爱
坐88路车回家	坐88路车回家
推奴	推奴
honey	honey
Coup d'Etat	Coup d'Etat
龙崎樱乃	龙崎樱乃
未来	未来
同乐会	同乐会
IRIS	IRIS
鹰巢之预备警官	鹰巢之预备警官
相逢有如梦中	相逢有如梦中
满秋	满秋
白色情人节	白色情人节
秋水长天	秋水长天
第一次	第一次
孙子从美国来	孙子从美国来
似曾相识	似曾相识
改变	改变
冲出死亡营	冲出死亡营
差不多先生	差不多先生
无憾青春	无憾青春
弓之骑士	弓之骑士
活着，真好	活着，真好
神勇双响炮	神勇双响炮
聚客镇	聚客镇
历书·乌衣	历书·乌衣
请将手放开	请将手放开
白雪公主	白雪公主
ova	ova
single boy	single boy
长生殿	长生殿
啊，海军	啊，海军
导弹旅长	导弹旅长
阿拉蕾	阿拉蕾
驯龙高手	驯龙高手
指环王	指环王
死党	死党
黄金稻浪	黄金稻浪
自闭历程	自闭历程
咒怨：黑少女	咒怨：黑少女
花与爱丽丝	花与爱丽丝
千言万语	千言万语
端盘子的姑娘	端盘子的姑娘
庵堂相会	庵堂相会
想自由	想自由
北海道	北海道
声声慢	声声慢
金枝欲孽贰	金枝欲孽贰
Do It Again	Do It Again
富贵列车	富贵列车
那女孩对我说	那女孩对我说
裂痕	裂痕
最后一站	最后一站
琉璃之岛	琉璃之岛
热情仲夏	热情仲夏
别把爱情当游戏	别把爱情当游戏
干探群英	干探群英
青春之歌	青春之歌
钢琴	钢琴
遇到	遇到
全民大闷锅	全民大闷锅
BAD BOYS J	BAD BOYS J
Roommate	Roommate
娘要嫁人	娘要嫁人
霍东阁	霍东阁
爱只是传说	爱只是传说
月光传说	月光传说
东方夜谭	东方夜谭
天蚕变之再与天比高	天蚕变之再与天比高
暂时失控	暂时失控
万箭穿心	万箭穿心
我可以抱你吗	我可以抱你吗
紫宅	紫宅
贼拉拉的爱你	贼拉拉的爱你
水无月香恋	水无月香恋
白银谷	白银谷
盔甲	盔甲
春天后母心	春天后母心
同桌的你	同桌的你
血誓	血誓
爱的Harmony	爱的Harmony
半夏	半夏
拯救	拯救
金银滩	金银滩
日光机场	日光机场
对花枪	对花枪
时间煮雨	时间煮雨
大时代	大时代
客户名单	客户名单
红圈	红圈
暴走	暴走
功夫·咏春	功夫·咏春
贺兰雪	贺兰雪
你好，疯子！	你好，疯子！
理发师	理发师
拯救地球	拯救地球
西贡小姐	西贡小姐
精装追女仔	精装追女仔
爱是无涯	爱是无涯
穷爸爸富爸爸	穷爸爸富爸爸
那一天	那一天
日月神剑	日月神剑
青春不停留	青春不停留
最佳损友	最佳损友
那一夜	那一夜
猛鬼通宵陪住你	猛鬼通宵陪住你
老鼠爱上猫	老鼠爱上猫
山村老尸	山村老尸
爱，很简单	爱，很简单
湄公河行动	湄公河行动
逝去日子	逝去日子
隐藏身份	隐藏身份
与你同住	与你同住
天外来客	天外来客
不留纪念	不留纪念
爱情新呼吸	爱情新呼吸
神探夏洛克	神探夏洛克
城市英雄	城市英雄
曲终人散	曲终人散
神的礼物-14天	神的礼物-14天
捡肥皂	捡肥皂
猜猜谁来吃晚餐	猜猜谁来吃晚餐
圣剑仙境传	圣剑仙境传
人在天涯	人在天涯
礼物	礼物
老千2 - 神之手	老千2 - 神之手
娱乐无极限	娱乐无极限
塔洛	塔洛
舞女泪	舞女泪
灰原哀	灰原哀
美妙人生	美妙人生
我在北京挺好的	我在北京挺好的
我的坏前辈	我的坏前辈
Mirror	Mirror
吉他里的阳光	吉他里的阳光
永远等待	永远等待
帽子戏法	帽子戏法
待到春花烂漫时	待到春花烂漫时
故梦	故梦
尽管如此也要活下去	尽管如此也要活下去
通灵警探之六棱镜	通灵警探之六棱镜
爱在深秋	爱在深秋
球爱酒吧	球爱酒吧
玻璃婚	玻璃婚
芳心的放纵	芳心的放纵
call my name	call my name
决胜21点	决胜21点
大长今	大长今
就是要你爱上我	就是要你爱上我
secret of my heart	secret of my heart
烂泥	烂泥
红楼春梦	红楼春梦
在线爱	在线爱
我的爱丑八怪	我的爱丑八怪
三人行	三人行
回到那年夏天	回到那年夏天
六楼后座	六楼后座
燕尾蝶	燕尾蝶
灵幻先生	灵幻先生
青河绝恋	青河绝恋
追捕	追捕
海芋恋	海芋恋
火葬	火葬
辛德瑞拉	辛德瑞拉
栖息于雾中的恶魔	栖息于雾中的恶魔
云之锦	云之锦
想你的夜	想你的夜
哈利·波特	哈利·波特
火狐浏览器	火狐浏览器
别拿自己不当干部	别拿自己不当干部
逆转王牌	逆转王牌
楚留香传奇	楚留香传奇
好想谈恋爱	好想谈恋爱
窦娥冤	窦娥冤
浮出水面的影子	浮出水面的影子
冬荫功	冬荫功
刺客信条	刺客信条
人形师	人形师
我的泪珠儿	我的泪珠儿
太极宗师	太极宗师
昨夜长风	昨夜长风
留给这世上我最爱的人	留给这世上我最爱的人
三傻大闹宝莱坞	三傻大闹宝莱坞
第八日的蝉	第八日的蝉
新疆	新疆
何勇	何勇
金在中	金在中
公仆	公仆
马前泼水	马前泼水
七十二家房客	七十二家房客
大管家	大管家
射手女神经	射手女神经
幸福很突然	幸福很突然
女店主	女店主
两杆大烟枪	两杆大烟枪
金沙别墅	金沙别墅
狩猎者	狩猎者
用歌声诉说爱情	用歌声诉说爱情
辛追传奇	辛追传奇
青龙好汉	青龙好汉
万诱女孩	万诱女孩
死刑台的电梯	死刑台的电梯
泰迪熊	泰迪熊
猎刃	猎刃
小幸运	小幸运
非我不可	非我不可
瑞典女王	瑞典女王
时空特警	时空特警
跆拳道	跆拳道
非常完美	非常完美
故事酒吧	故事酒吧
结·分@谎情式	结·分@谎情式
青鸟的天空	青鸟的天空
义	义
中国的月亮	中国的月亮
小洋楼	小洋楼
美人季	美人季
终极底牌	终极底牌
加油吧实习生	加油吧实习生
北上广不相信眼泪	北上广不相信眼泪
青红	青红
天地在我心	天地在我心
欧罗拉公主	欧罗拉公主
食来孕转	食来孕转
梨泰院杀人事件	梨泰院杀人事件
大腕	大腕
密阳	密阳
云袖	云袖
太空步	太空步
女杰	女杰
m	m
想说	想说
春梅	春梅
泡沫之夏	泡沫之夏
丝丝心动	丝丝心动
时尚70年代	时尚70年代
好好恋爱	好好恋爱
伊甸园	伊甸园
伤感的恋人	伤感的恋人
音乐之声	音乐之声
七剑震江湖	七剑震江湖
德州电锯杀人狂	德州电锯杀人狂
中国梦	中国梦
time after time	time after time
新圆月弯刀	新圆月弯刀
玛丽关77	玛丽关77
时间都知道	时间都知道
全城热恋	全城热恋
老哨卡	老哨卡
戏王之王	戏王之王
烟雨唱扬州	烟雨唱扬州
Click入黄金屋	Click入黄金屋
染井吉野	染井吉野
斯巴达克斯：血与沙	斯巴达克斯：血与沙
美丽七人行	美丽七人行
亲爱的	亲爱的
皇室风流史	皇室风流史
亲爱的我们结婚吧	亲爱的我们结婚吧
History	History
公主日记	公主日记
笑侃大上海	笑侃大上海
香港回归	香港回归
monica	monica
污垢	污垢
疤面煞星	疤面煞星
搜下留情	搜下留情
泪洒相思地	泪洒相思地
寂寞的季节	寂寞的季节
我的女儿是花儿	我的女儿是花儿
月亮湾的笑声	月亮湾的笑声
天外飞仙	天外飞仙
浪漫岛屿	浪漫岛屿
blowing in the wind	blowing in the wind
樱桃小丸子	樱桃小丸子
清凌凌的水蓝莹莹的天	清凌凌的水蓝莹莹的天
悬崖	悬崖
花开的季节	花开的季节
男孩勿碰	男孩勿碰
一个人跳舞	一个人跳舞
情定爱琴海	情定爱琴海
迷恋	迷恋
in the wind	in the wind
我的根在草原	我的根在草原
他来了	他来了
啼笑因缘	啼笑因缘
分手就分手	分手就分手
凰图腾	凰图腾
终极斗士3：赎罪	终极斗士3：赎罪
天地有情	天地有情
头摆的你	头摆的你
七擒七纵七色狼	七擒七纵七色狼
大当家	大当家
飞女正传	飞女正传
将军在上	将军在上
魔幻时刻	魔幻时刻
大河奔流	大河奔流
流浪者之歌	流浪者之歌
楚汉传奇	楚汉传奇
苏樱	苏樱
小宇宙	小宇宙
火力少年王3	火力少年王3
爸爸快长大	爸爸快长大
守护boss	守护boss
机动战舰	机动战舰
古惑仔3之只手遮天	古惑仔3之只手遮天
大宅院的女人	大宅院的女人
藏地密码	藏地密码
对不起青春	对不起青春
喜剧之王	喜剧之王
爱丽丝梦游仙境	爱丽丝梦游仙境
痴心不改	痴心不改
城市拳击手	城市拳击手
江山美人	江山美人
刀锋战士	刀锋战士
空镜子	空镜子
藤崎佑助	藤崎佑助
检事	检事
李红袖	李红袖
好胜男孩	好胜男孩
宫泽雪野	宫泽雪野
蓝宇	蓝宇
一半天堂	一半天堂
为您点餐	为您点餐
陈小云	陈小云
一个人的精彩	一个人的精彩
快乐成双	快乐成双
杀戮都市	杀戮都市
布朗夫人	布朗夫人
六月的日记	六月的日记
失控谎言	失控谎言
学校2013	学校2013
多久之后	多久之后
雪域迷城	雪域迷城
九阴真经	九阴真经
遇见爱情的利先生	遇见爱情的利先生
乡里妹子进城来	乡里妹子进城来
水手服与机关枪	水手服与机关枪
奇迹餐厅	奇迹餐厅
聊斋艳谭3：灯草和尚	聊斋艳谭3：灯草和尚
天下女人心	天下女人心
爱的替身	爱的替身
玄幻音乐	玄幻音乐
我的快乐就是想你	我的快乐就是想你
好心作怪	好心作怪
窗外	窗外
生命的祭坛	生命的祭坛
刘老根	刘老根
下一站婚姻	下一站婚姻
青盲	青盲
白金数据	白金数据
春天的雨	春天的雨
谢谢你	谢谢你
火的洗礼	火的洗礼
木府风云	木府风云
我老婆未满十八岁	我老婆未满十八岁
天若有情	天若有情
离婚再婚	离婚再婚
刺	刺
庙街故事	庙街故事
闹钗	闹钗
恋爱季节	恋爱季节
动乱	动乱
国门英雄	国门英雄
眼泪的秘密	眼泪的秘密
猜不透	猜不透
万家科学	万家科学
死亡罪证	死亡罪证
爱的生存之道	爱的生存之道
守望者	守望者
足球风云	足球风云
走出非洲	走出非洲
雪落下的声音	雪落下的声音
天涯明月刀	天涯明月刀
醉后一夜	醉后一夜
女人行	女人行
心淡	心淡
命中注定	命中注定
萌学园：萌骑士传奇	萌学园：萌骑士传奇
魔法禁书目录	魔法禁书目录
美妙的奇遇	美妙的奇遇
牡丹鹦鹉	牡丹鹦鹉
光荣岁月	光荣岁月
飞鸟与鱼	飞鸟与鱼
中国范儿	中国范儿
祝女第三季	祝女第三季
天边	天边
快乐对不快乐说	快乐对不快乐说
不能错过	不能错过
贞子3D	贞子3D
凡夫俗女	凡夫俗女
新萧十一郎	新萧十一郎
山林喋血	山林喋血
韩国小姐	韩国小姐
我亲爱的爸爸	我亲爱的爸爸
酷爱	酷爱
黎明前的抉择	黎明前的抉择
情咒	情咒
萍踪侠影	萍踪侠影
大清炮队	大清炮队
我这个你不爱的人	我这个你不爱的人
孤男寡女	孤男寡女
十八愁绕口令	十八愁绕口令
白领公寓	白领公寓
豪杰春香	豪杰春香
梦幻女郎	梦幻女郎
94独臂刀之情	94独臂刀之情
被情伤过的女人	被情伤过的女人
曹雪芹	曹雪芹
魔力魔力	魔力魔力
李双双	李双双
Over The Way	Over The Way
妈妈圈的流言蜚语	妈妈圈的流言蜚语
蝙蝠侠：黑暗骑士崛起	蝙蝠侠：黑暗骑士崛起
满堂红	满堂红
我要上太空	我要上太空
风雨真情	风雨真情
拾起的布偶	拾起的布偶
日向花火	日向花火
烈火雄心	烈火雄心
let it go	let it go
粉红系男孩	粉红系男孩
天堂之吻	天堂之吻
女帝薰子	女帝薰子
拭血问剑	拭血问剑
千王之王重出江湖	千王之王重出江湖
李宗盛	李宗盛
我会等你	我会等你
谍·莲花	谍·莲花
豹子胆	豹子胆
千面天王	千面天王
圣诞快乐，劳伦斯先生	圣诞快乐，劳伦斯先生
罗宾汉	罗宾汉
我妻子的一切	我妻子的一切
小孩大人	小孩大人
安静	安静
师奶唔易做	师奶唔易做
新还珠格格	新还珠格格
谁主沉浮	谁主沉浮
男和女	男和女
unfair	unfair
独养女儿	独养女儿
极速的浪漫青春	极速的浪漫青春
老公的春天	老公的春天
二子开店	二子开店
战	战
羽丘芽美	羽丘芽美
浴血坚持	浴血坚持
超体	超体
雁南飞	雁南飞
中国最强音	中国最强音
夜鹰	夜鹰
双城生活	双城生活
LOVE IS	LOVE IS
刘斌升	刘斌升
SEXY VOICE AND ROBO	SEXY VOICE AND ROBO
疯了吗	疯了吗
记得你	记得你
春光灿烂猪八戒	春光灿烂猪八戒
守约	守约
赛文·奥特曼	赛文·奥特曼
烟火	烟火
一起去巴黎	一起去巴黎
我爱记歌词	我爱记歌词
turn up the music	turn up the music
北魏传奇之情缘	北魏传奇之情缘
秦时明月	秦时明月
达子的春天	达子的春天
自定义	自定义
菩提达摩	菩提达摩
我们这拨人	我们这拨人
守望幸福	守望幸福
龙的眼泪	龙的眼泪
最后一战	最后一战
我心深处	我心深处
铁甲钢拳	铁甲钢拳
安全感	安全感
终结者	终结者
红楼梦	红楼梦
郁金香	郁金香
黑裙子	黑裙子
康熙来了	康熙来了
真相禁区	真相禁区
福星高照猪八戒	福星高照猪八戒
香格里拉	香格里拉
夜雨霏霏	夜雨霏霏
荣归	荣归
心中的太阳	心中的太阳
奥运大郭饭	奥运大郭饭
www	www
名声大噪	名声大噪
盗梦空间	盗梦空间
狐狸	狐狸
勾践	勾践
火野丽	火野丽
你一定要幸福	你一定要幸福
小孩不笨	小孩不笨
DARKER THAN BLACK -黑之契约者-	DARKER THAN BLACK -黑之契约者-
白袍之恋	白袍之恋
怪医黑杰克	怪医黑杰克
短信一月追	短信一月追
大话西游之大圣娶亲	大话西游之大圣娶亲
宫心计	宫心计
笼民	笼民
狂潮	狂潮
海洋	海洋
大只佬	大只佬
PTU	PTU
白日焰火	白日焰火
贵妃醉酒	贵妃醉酒
田园日记	田园日记
甜孙爷爷	甜孙爷爷
真Live真音乐	真Live真音乐
海浪	海浪
江湖奇侠传	江湖奇侠传
咖啡季节	咖啡季节
美人私房菜	美人私房菜
莲花雨	莲花雨
黑蝴蝶	黑蝴蝶
如父如子	如父如子
犀照	犀照
大脚马皇后	大脚马皇后
相爱穿梭千年2：月光下的交换	相爱穿梭千年2：月光下的交换
怪爱太天真	怪爱太天真
麻烦男人	麻烦男人
乡村爱情故事	乡村爱情故事
我也是花	我也是花
婚礼进行曲	婚礼进行曲
狼烟	狼烟
万家灯火	万家灯火
刁蛮公主	刁蛮公主
热武青春2	热武青春2
我永远是你的	我永远是你的
外来媳妇本地郎	外来媳妇本地郎
爱江山更爱美人	爱江山更爱美人
Rainism	Rainism
惊雷行动	惊雷行动
单程车票	单程车票
幽灵女友	幽灵女友
最后的较量	最后的较量
长腿姐姐	长腿姐姐
大宋惊世传奇	大宋惊世传奇
历程	历程
中国好声音第四季	中国好声音第四季
团子大家族	团子大家族
老威的X计划	老威的X计划
活佛济公第三部	活佛济公第三部
荃加福禄寿	荃加福禄寿
In My Head	In My Head
刘彻	刘彻
扈三娘与矮脚虎王英	扈三娘与矮脚虎王英
铁窗红泪	铁窗红泪
海誓	海誓
TO BE	TO BE
赤沙印记@四叶草2	赤沙印记@四叶草2
母亲心	母亲心
running man	running man
女人如歌	女人如歌
后生我辈自在	后生我辈自在
泪海	泪海
信	信
追击	追击
一把青	一把青
周恩来	周恩来
离伤	离伤
一个和八个	一个和八个
野雁高飞	野雁高飞
老人与海	老人与海
爱情最美丽	爱情最美丽
贝壳风铃	贝壳风铃
致命武器	致命武器
冒牌恋人	冒牌恋人
陆小凤传奇	陆小凤传奇
何必西天万里遥	何必西天万里遥
大保镖	大保镖
我的淘气天使	我的淘气天使
百老汇上空的子弹	百老汇上空的子弹
小鬼当家2	小鬼当家2
广告天才李泰白	广告天才李泰白
冲田总悟	冲田总悟
神腿铁扇功	神腿铁扇功
监灵神探	监灵神探
摩登家庭	摩登家庭
缘来是爱	缘来是爱
叶问	叶问
论捧逗	论捧逗
郎心似铁	郎心似铁
铃声叮咚	铃声叮咚
完美对垒	完美对垒
综艺100	综艺100
暖	暖
天下无双	天下无双
盖亚	盖亚
胡不归	胡不归
哭灵	哭灵
宫藤芳佳	宫藤芳佳
最好不相见	最好不相见
全城高考	全城高考
世界上最美丽的离别	世界上最美丽的离别
孤恋花	孤恋花
成人记	成人记
花无雪	花无雪
柠檬恋人	柠檬恋人
与犯罪的战争	与犯罪的战争
热血	热血
我的美丽王国	我的美丽王国
Stronger	Stronger
摇滚校园	摇滚校园
模特秀	模特秀
天路	天路
白线流	白线流
刻骨的温柔	刻骨的温柔
信仰	信仰
像天堂的悬崖	像天堂的悬崖
明星同乐会	明星同乐会
李米的猜想	李米的猜想
我忍不了	我忍不了
超级女特工	超级女特工
张纪中	张纪中
武田信玄	武田信玄
佐天泪子	佐天泪子
末路英雄半世情	末路英雄半世情
聊斋新编	聊斋新编
这条街	这条街
妖精	妖精
倔强	倔强
铁齿铜牙纪晓岚	铁齿铜牙纪晓岚
太阳·风的思念	太阳·风的思念
巴尔扎克和小裁缝	巴尔扎克和小裁缝
一克拉梦想	一克拉梦想
一线缉毒	一线缉毒
爱一直闪亮	爱一直闪亮
伤心酒店	伤心酒店
女生日记	女生日记
007之雷霆谷	007之雷霆谷
爱你爱的好悲伤	爱你爱的好悲伤
盐娃娃	盐娃娃
蜂蜜幸运草	蜂蜜幸运草
齐天大盛	齐天大盛
嘻唰唰	嘻唰唰
悲情城市	悲情城市
满天都是陈予新	满天都是陈予新
睡莲	睡莲
殭	殭
表演	表演
爱我的每个人	爱我的每个人
这个杀手不太冷	这个杀手不太冷
日以继夜	日以继夜
Not Myself Tonight	Not Myself Tonight
守法公民	守法公民
精武风云·陈真	精武风云·陈真
西街少年	西街少年
国家干部	国家干部
铁道飞虎	铁道飞虎
外婆的澎湖湾	外婆的澎湖湾
血色将至	血色将至
未来制造工厂	未来制造工厂
夜半梳头	夜半梳头
樱花通信	樱花通信
Only Girl 	Only Girl 
流浪歌	流浪歌
老井	老井
大力女都奉顺	大力女都奉顺
加油站被袭事件	加油站被袭事件
明天会更好	明天会更好
人狼游戏	人狼游戏
步步惊心	步步惊心
追魂交易	追魂交易
怎么爱你都不够	怎么爱你都不够
往事只能回味	往事只能回味
家有儿女2	家有儿女2
家有儿女3	家有儿女3
家有四千金	家有四千金
锁定美军特使	锁定美军特使
绝密押运	绝密押运
少林五祖	少林五祖
一开始你就不是认真的	一开始你就不是认真的
办公室	办公室
大桥下面	大桥下面
哥斯拉	哥斯拉
情人结	情人结
北京人在纽约	北京人在纽约
猎头	猎头
卖油郎独占花魁	卖油郎独占花魁
甄嬛后传	甄嬛后传
我本善良	我本善良
西施梦	西施梦
玄奘西游记	玄奘西游记
神探李奇	神探李奇
笑红颜	笑红颜
在一起多好	在一起多好
生死卧底	生死卧底
她在睡梦中	她在睡梦中
山海经之赤影传说	山海经之赤影传说
前妻的车站	前妻的车站
抽屉	抽屉
蝙蝠别墅	蝙蝠别墅
国际市场	国际市场
大好时光	大好时光
迎妻接福	迎妻接福
饥饿的青春	饥饿的青春
萧峰	萧峰
警视厅继续搜查班	警视厅继续搜查班
裂缝	裂缝
GRENADE	GRENADE
做自己	做自己
学警狙击	学警狙击
东归英雄传	东归英雄传
妈妈留给我一首歌	妈妈留给我一首歌
红灯记	红灯记
咒怨2	咒怨2
终极匹配	终极匹配
听海	听海
魔法奇缘	魔法奇缘
天使的微笑	天使的微笑
101次求婚	101次求婚
少女慈禧	少女慈禧
妈妈再爱我一次	妈妈再爱我一次
男孩向前冲	男孩向前冲
你的选择	你的选择
纳尼亚传奇：凯斯宾王子	纳尼亚传奇：凯斯宾王子
五星大饭店	五星大饭店
雷锋	雷锋
平清盛	平清盛
财迷	财迷
莉娜·因巴斯	莉娜·因巴斯
疯狂初恋	疯狂初恋
康定情歌	康定情歌
快乐中国	快乐中国
囧西游	囧西游
o记实录	o记实录
给我一个理由忘记	给我一个理由忘记
不可思议的海岸物语	不可思议的海岸物语
女人女人	女人女人
我的宝贝	我的宝贝
星期天的爱恋	星期天的爱恋
别离的预感	别离的预感
南风	南风
男人女人	男人女人
心跳！光之美少女	心跳！光之美少女
碧血书香梦	碧血书香梦
断喉弩	断喉弩
强袭魔女	强袭魔女
当年情	当年情
童养媳	童养媳
雪之女王	雪之女王
半支烟	半支烟
To Heart2	To Heart2
五亿探长雷洛传	五亿探长雷洛传
杜鹃	杜鹃
姑娘今年二十八	姑娘今年二十八
爱的牵绊	爱的牵绊
柠檬初上	柠檬初上
他们生活的世界	他们生活的世界
第二次求婚	第二次求婚
沉睡的野兽	沉睡的野兽
127小时	127小时
S最后的警官	S最后的警官
吐司男之吻	吐司男之吻
蓝蓝的天蓝蓝的梦	蓝蓝的天蓝蓝的梦
爱过痛过哭过	爱过痛过哭过
君麻吕	君麻吕
随波逐流	随波逐流
缝纫机乐队	缝纫机乐队
宝岛双雄	宝岛双雄
方糖	方糖
红尘	红尘
Sing to the Sky	Sing to the Sky
蛋神奇踪	蛋神奇踪
crazy	crazy
青瓷	青瓷
上海正午	上海正午
母仪天下	母仪天下
Life人生	Life人生
渗透	渗透
72小姐	72小姐
大笑江湖	大笑江湖
亲爱的女孩	亲爱的女孩
在和平年代	在和平年代
刺客	刺客
水云间	水云间
樱桃红	樱桃红
人生有缘	人生有缘
阳光满溢	阳光满溢
独眼龙政宗	独眼龙政宗
野山	野山
超者雷登	超者雷登
孔繁森	孔繁森
音乐江湖	音乐江湖
雾之恋	雾之恋
头号公敌续集	头号公敌续集
深闺疑云	深闺疑云
神医喜来乐	神医喜来乐
乘着歌声的爱情	乘着歌声的爱情
School OZ	School OZ
上海屋檐下	上海屋檐下
秋天2002	秋天2002
老炮儿	老炮儿
甜心先生	甜心先生
霹雳红唇	霹雳红唇
豪斯医生	豪斯医生
全日爱	全日爱
后会无期	后会无期
抖抖傲	抖抖傲
多情江山	多情江山
止月牛土寸	止月牛土寸
魔法的禁书目录	魔法的禁书目录
生命因爱动听	生命因爱动听
布鲁克林警察	布鲁克林警察
让我们相爱	让我们相爱
春风沉醉的夜晚	春风沉醉的夜晚
乌龙派出所	乌龙派出所
恋爱学分	恋爱学分
浮夸	浮夸
刚好遇见你	刚好遇见你
不能失去你	不能失去你
搞笑漫画日和	搞笑漫画日和
太刀川美美	太刀川美美
战友故事	战友故事
六月雪	六月雪
第四张画	第四张画
彩虹甜心	彩虹甜心
新长征路上的摇滚	新长征路上的摇滚
偷天陷阱	偷天陷阱
钢的琴	钢的琴
与卡戴珊姐妹同行	与卡戴珊姐妹同行
别活的太累	别活的太累
只要有你在	只要有你在
禁猎区	禁猎区
年轻的朋友来相会	年轻的朋友来相会
FANTASY	FANTASY
战争子午线	战争子午线
happy together3	happy together3
偷心大圣PS男	偷心大圣PS男
虹猫蓝兔七侠传	虹猫蓝兔七侠传
再造战士	再造战士
世界奇妙物语	世界奇妙物语
大唐歌飞	大唐歌飞
领航中国	领航中国
别再说你爱着我	别再说你爱着我
记得-儿子的战争	记得-儿子的战争
给你的情书	给你的情书
i still believe	i still believe
毛丝鼠	毛丝鼠
侦探的侦探	侦探的侦探
国光异校	国光异校
三七撞上二十一	三七撞上二十一
三个女人的秘密	三个女人的秘密
人不是我杀的	人不是我杀的
人鬼情未了	人鬼情未了
一半海水一半火焰	一半海水一半火焰
昭君出塞	昭君出塞
如果没有离开	如果没有离开
爱·回家	爱·回家
宛如阿修罗	宛如阿修罗
陈冠希	陈冠希
满山打鬼子	满山打鬼子
濑户灿	濑户灿
母亲快乐	母亲快乐
花样少年少女2011	花样少年少女2011
哆来咪发唆	哆来咪发唆
认真的雪	认真的雪
站直啰别趴下	站直啰别趴下
郭小宝和周老财	郭小宝和周老财
4400	4400
远得要命的爱情	远得要命的爱情
Hi上班女郎	Hi上班女郎
问情	问情
他们在毕业的前一天爆炸	他们在毕业的前一天爆炸
开门大吉	开门大吉
刀见笑	刀见笑
007之诺博士	007之诺博士
心战	心战
第一千个男人	第一千个男人
武林外史	武林外史
再见	再见
不想做朋友	不想做朋友
刁蛮公主戆驸马	刁蛮公主戆驸马
一个好爸爸	一个好爸爸
怒火街头	怒火街头
宝莲灯前传	宝莲灯前传
北方有佳人	北方有佳人
蓝染惣右介	蓝染惣右介
爱你恨你	爱你恨你
龙门镖局	龙门镖局
战马	战马
神探可伦坡	神探可伦坡
呼啸山庄	呼啸山庄
生锈桥王	生锈桥王
浪子燕青	浪子燕青
公私恋事多	公私恋事多
梦断紫禁城	梦断紫禁城
瑰宝	瑰宝
新心	新心
甜甜圈	甜甜圈
温差	温差
美少女战士真人版	美少女战士真人版
人间中毒	人间中毒
儿女传奇	儿女传奇
乌鲁木齐的天空	乌鲁木齐的天空
刑事侦缉档案II	刑事侦缉档案II
劫后新生	劫后新生
我们的纯真年代	我们的纯真年代
末日	末日
温州	温州
雨	雨
分手吧	分手吧
龙凤呈祥贺台庆	龙凤呈祥贺台庆
回路	回路
明骏女孩	明骏女孩
可鲁贝洛斯	可鲁贝洛斯
我的眼里只有你	我的眼里只有你
My盛Lady	My盛Lady
刑事侦缉档案IV	刑事侦缉档案IV
神奇四侠	神奇四侠
单人	单人
极乐岛杀人事件	极乐岛杀人事件
京城绯闻	京城绯闻
山河水	山河水
顽主	顽主
惩毖录	惩毖录
天使的翅膀	天使的翅膀
嫦娥	嫦娥
夜·色	夜·色
我们都是这样长大的	我们都是这样长大的
现代爱情故事	现代爱情故事
点金神手	点金神手
班淑传奇	班淑传奇
中国特警	中国特警
一人一梦	一人一梦
我爱男保姆	我爱男保姆
海娃的歌	海娃的歌
逍遥法外	逍遥法外
眼，鼻，嘴	眼，鼻，嘴
刺夜	刺夜
女人本色	女人本色
我的果汁分你一半	我的果汁分你一半
非常6+1	非常6+1
你好吗	你好吗
安昙春子下落不明	安昙春子下落不明
香港有个荷里活	香港有个荷里活
从今以后	从今以后
浪漫爱人	浪漫爱人
三更之回家	三更之回家
Stylish	Stylish
义侠护工	义侠护工
古手梨花	古手梨花
说爱你	说爱你
山花开	山花开
杰利特·梅萨	杰利特·梅萨
爱情睡醒了	爱情睡醒了
路	路
气球	气球
双天至尊	双天至尊
军人机密	军人机密
日落卡门	日落卡门
给幸福下订单	给幸福下订单
oh我的鬼神大人	oh我的鬼神大人
不是谁都能爱	不是谁都能爱
做我老婆好不好	做我老婆好不好
孛儿只斤·铁木真	孛儿只斤·铁木真
长江7号	长江7号
传说的魔女	传说的魔女
活力大冲关	活力大冲关
女王不下班	女王不下班
虎胆雄心	虎胆雄心
男亲女爱	男亲女爱
国家代表	国家代表
四世同堂	四世同堂
艾欧里亚	艾欧里亚
007：大破天幕杀机	007：大破天幕杀机
我爱罗	我爱罗
失恋无罪	失恋无罪
So Wonderful	So Wonderful
想象	想象
王与我	王与我
摆渡人	摆渡人
情感之旅	情感之旅
夏天的风	夏天的风
爱有明天	爱有明天
大兵小将	大兵小将
条子阿不拉	条子阿不拉
放羊的星星	放羊的星星
独静加	独静加
惊声尖叫	惊声尖叫
西安杀戮	西安杀戮
我从西边来	我从西边来
十二生肖	十二生肖
大刀记	大刀记
自由的飞	自由的飞
终极一班	终极一班
良心	良心
风暴潮	风暴潮
妈祖	妈祖
梅兰芳	梅兰芳
提防老千	提防老千
520从今天	520从今天
英雄使命	英雄使命
金水桥边	金水桥边
河东狮吼	河东狮吼
人人都爱雷蒙德	人人都爱雷蒙德
三个未婚妈妈	三个未婚妈妈
辣妈正传	辣妈正传
远古的传说	远古的传说
裸漂	裸漂
我的美女老板	我的美女老板
Domino	Domino
东柱	东柱
皇家师姐3：雌雄大盗	皇家师姐3：雌雄大盗
烽火英雄传	烽火英雄传
开饭了	开饭了
前度	前度
姻缘花	姻缘花
荷塘月色	荷塘月色
东方三侠	东方三侠
大千世界	大千世界
call me baby	call me baby
等风来	等风来
他不准我哭	他不准我哭
环太平洋	环太平洋
新金瓶梅	新金瓶梅
我的心好冷	我的心好冷
推理要在晚餐后	推理要在晚餐后
世界的状态	世界的状态
杀破狼	杀破狼
Run It!	Run It!
井柏然	井柏然
青出于蓝	青出于蓝
Gussanova 谷萨诺瓦	Gussanova 谷萨诺瓦
醉玲珑	醉玲珑
国光帮帮忙	国光帮帮忙
小汪刑警	小汪刑警
今世有缘	今世有缘
四郎探母	四郎探母
黑气球	黑气球
王的面孔	王的面孔
满山红叶似彩霞	满山红叶似彩霞
超级乐8点	超级乐8点
北京北京我爱北京	北京北京我爱北京
双簧	双簧
玉面飞狐	玉面飞狐
天浴	天浴
爱出色	爱出色
惊爆点	惊爆点
抹布女孩	抹布女孩
鬼语者	鬼语者
手扶拖拉机斯基	手扶拖拉机斯基
雅典娜：战争女神	雅典娜：战争女神
电台情歌	电台情歌
寻雾启示	寻雾启示
gee	gee
桃色案件	桃色案件
Tamama	Tamama
银楼金粉	银楼金粉
洪熙官	洪熙官
江南美	江南美
换乐无穷	换乐无穷
小黄英大太阳	小黄英大太阳
家宴	家宴
夜来风雨	夜来风雨
慢慢地陪着你走	慢慢地陪着你走
勇士们	勇士们
台湾阿诚	台湾阿诚
实诚	实诚
夺命金	夺命金
又见橘花香	又见橘花香
我们天上见	我们天上见
绽放2.0	绽放2.0
风之谷	风之谷
粉红女郎	粉红女郎
展昭	展昭
龙虎风云	龙虎风云
心情好又暖	心情好又暖
嬢王	嬢王
爱情万万岁	爱情万万岁
百万巨鳄	百万巨鳄
青燕	青燕
情越双白线	情越双白线
琦迹	琦迹
包青天之七侠五义	包青天之七侠五义
猛龙怪客	猛龙怪客
王牌天使	王牌天使
于成龙	于成龙
马不停蹄的忧伤	马不停蹄的忧伤
diamonds	diamonds
周日八点党	周日八点党
跳水男孩	跳水男孩
一天到晚游泳的鱼	一天到晚游泳的鱼
窃听风云3	窃听风云3
黄手帕	黄手帕
眼色	眼色
心太软	心太软
大唐情史	大唐情史
倾城之恋	倾城之恋
情深说话未曾讲	情深说话未曾讲
别怕有我	别怕有我
十三不搭	十三不搭
心里话	心里话
飞天潜龙	飞天潜龙
好女十八变	好女十八变
挑夫	挑夫
白金9人组	白金9人组
飞得更高	飞得更高
山里的女人喊太阳	山里的女人喊太阳
大约在冬季	大约在冬季
fly to the sky	fly to the sky
冬狮	冬狮
恶作剧之吻	恶作剧之吻
震撼	震撼
爱情诺曼底	爱情诺曼底
越狱	越狱
东方茱丽叶	东方茱丽叶
当旺爸爸	当旺爸爸
娘家的故事	娘家的故事
月亮之上	月亮之上
狂放	狂放
金瓶双艳	金瓶双艳
包法利夫人	包法利夫人
面包树上的女人	面包树上的女人
拾玉镯	拾玉镯
欢喜婆婆俏媳妇	欢喜婆婆俏媳妇
镖行天下前传	镖行天下前传
处女之路	处女之路
沙漠王子	沙漠王子
笔墨纸砚	笔墨纸砚
莎丽	莎丽
大清后宫之还君明珠	大清后宫之还君明珠
决杀	决杀
生死抉择	生死抉择
铁马战车	铁马战车
Blame It	Blame It
天然子结构	天然子结构
wedding dress	wedding dress
一个男人	一个男人
洗澡	洗澡
女人不坏	女人不坏
爱拼才会赢	爱拼才会赢
你的承诺	你的承诺
解密	解密
威尼斯恋人	威尼斯恋人
新世纪福音战士	新世纪福音战士
法医秦明	法医秦明
新独臂刀	新独臂刀
电话机	电话机
问月	问月
警察世家	警察世家
我期待	我期待
无名指	无名指
猎人笔记之谜	猎人笔记之谜
爱德华·纽盖特	爱德华·纽盖特
梦断情殇	梦断情殇
19岁的纯情	19岁的纯情
为爱疯狂	为爱疯狂
金石良缘	金石良缘
圆舞曲	圆舞曲
西游记之孙悟空三打白骨精	西游记之孙悟空三打白骨精
末代独裁	末代独裁
穷孩子富孩子	穷孩子富孩子
flavor of life	flavor of life
全为了你	全为了你
特种部队：全面反击	特种部队：全面反击
圈套剧场版4：最后的舞台	圈套剧场版4：最后的舞台
欢天喜地	欢天喜地
再见亦是老婆	再见亦是老婆
好乐Day	好乐Day
恶灵05	恶灵05
天使艾美丽	天使艾美丽
冲锋车	冲锋车
说客	说客
传颂之物	传颂之物
中国海的怒潮	中国海的怒潮
碧波仙子	碧波仙子
状元亲家	状元亲家
神医传奇	神医传奇
没有人比我更爱你	没有人比我更爱你
妈妈的选择	妈妈的选择
降魔师之血僵尸	降魔师之血僵尸
阳光下的星星	阳光下的星星
不配做你男朋友	不配做你男朋友
钟声	钟声
爱情呼叫转移	爱情呼叫转移
扬子江风云	扬子江风云
我不会说话	我不会说话
再续前缘	再续前缘
Don't touch my girl	Don't touch my girl
南海十三郎	南海十三郎
奥赛罗	奥赛罗
好想告诉你	好想告诉你
黎明前夕最黑暗	黎明前夕最黑暗
我祝愿	我祝愿
乘胜长驱	乘胜长驱
异镇	异镇
壮志凌云	壮志凌云
爱情红绿灯	爱情红绿灯
不如跳舞	不如跳舞
ALICE	ALICE
刑事侦缉档案	刑事侦缉档案
猫的葬礼	猫的葬礼
家在南三条	家在南三条
对白	对白
四季歌	四季歌
女子特警队	女子特警队
呼叫大明星	呼叫大明星
电车男	电车男
重案六组	重案六组
水中花	水中花
美女公寓	美女公寓
网球甜心	网球甜心
张玉贞	张玉贞
向阳素描	向阳素描
连环记	连环记
California Gurls	California Gurls
我的父亲母亲	我的父亲母亲
燃烧的玫瑰	燃烧的玫瑰
风雨	风雨
无敌的降落伞要员	无敌的降落伞要员
蔷薇色的布子	蔷薇色的布子
候车室的故事	候车室的故事
逆时营救	逆时营救
月半小夜曲	月半小夜曲
樱坂	樱坂
唐山大地震	唐山大地震
麦兜响当当	麦兜响当当
共同警备区	共同警备区
触不到的恋人	触不到的恋人
黄洋界保卫战	黄洋界保卫战
爱与和平	爱与和平
沂蒙	沂蒙
人间烟火	人间烟火
无间有爱	无间有爱
无地自容	无地自容
千纸鹤	千纸鹤
悲喜亲家	悲喜亲家
24小时	24小时
今天是你的生日，妈妈	今天是你的生日，妈妈
家，N次方	家，N次方
惊心动魄	惊心动魄
春光美	春光美
制作人	制作人
毒品网络	毒品网络
回家的诱惑	回家的诱惑
警察故事	警察故事
欢乐合唱团	欢乐合唱团
客满座酒满桌	客满座酒满桌
大太监	大太监
天国王朝	天国王朝
百变天使	百变天使
爱情神马价	爱情神马价
春江月	春江月
香港奇案实录	香港奇案实录
哑女情深	哑女情深
初恋	初恋
晚间新闻	晚间新闻
横冲直撞好莱坞	横冲直撞好莱坞
南北少林	南北少林
青春之杀人者	青春之杀人者
庆幸有你爱我	庆幸有你爱我
汤姆叔叔的小屋	汤姆叔叔的小屋
洋娃娃	洋娃娃
再生缘	再生缘
花灯满城	花灯满城
新甘十九妹	新甘十九妹
神犬小七	神犬小七
女人不哭	女人不哭
放弃你	放弃你
101忠狗	101忠狗
大王世宗	大王世宗
暮光之城	暮光之城
I dreamed a dream	I dreamed a dream
丑女贝蒂	丑女贝蒂
醒醒吧，XX	醒醒吧，XX
狄仁杰	狄仁杰
太阳出来了	太阳出来了
远山的呼唤	远山的呼唤
血色迷雾	血色迷雾
蜂鸟	蜂鸟
给自己的歌	给自己的歌
师妹出马	师妹出马
双截棍	双截棍
诚实国度的爱丽丝	诚实国度的爱丽丝
dream high	dream high
致命替身	致命替身
幸福从天而降	幸福从天而降
爱的星座	爱的星座
四骑士	四骑士
突然发财	突然发财
仰望	仰望
爱转角	爱转角
记事本	记事本
小男人遇上大女人	小男人遇上大女人
功夫瑜伽	功夫瑜伽
非常爱情狂	非常爱情狂
大贪官和珅	大贪官和珅
致匆匆那些年	致匆匆那些年
亚瑟和他的迷你王国	亚瑟和他的迷你王国
武状元苏乞儿	武状元苏乞儿
孩子回国了	孩子回国了
情定上海滩	情定上海滩
大象	大象
一事无成	一事无成
黎明破晓前	黎明破晓前
鉴真东渡	鉴真东渡
绿色的旋律	绿色的旋律
夏洛克·福尔摩斯	夏洛克·福尔摩斯
青青河边草	青青河边草
法官妈妈	法官妈妈
游戏王GX	游戏王GX
建筑有情天	建筑有情天
魔戒	魔戒
萨娜在昆明	萨娜在昆明
情牵一线	情牵一线
新寡	新寡
爱上九点半	爱上九点半
迪迦·奥特曼	迪迦·奥特曼
冷雨夜	冷雨夜
玩命快递	玩命快递
One More Chance	One More Chance
东京爱情故事	东京爱情故事
火拼曼哈顿	火拼曼哈顿
孤岛飞鹰	孤岛飞鹰
谈判专家	谈判专家
昙花梦	昙花梦
奥特曼传奇	奥特曼传奇
玛戈皇后	玛戈皇后
梦想星光	梦想星光
天泪传奇之凤凰无双	天泪传奇之凤凰无双
机动战士高达seed	机动战士高达seed
乌托邦办公室	乌托邦办公室
白蛇传说	白蛇传说
欢喜就好	欢喜就好
冲呀！瘦薪兵团	冲呀！瘦薪兵团
每个人的一生都是一次远行	每个人的一生都是一次远行
Documentary	Documentary
霹雳娇娃	霹雳娇娃
心不再遥远	心不再遥远
那又如何	那又如何
感应少年	感应少年
怒火英雄	怒火英雄
急性酒精中毒	急性酒精中毒
Q10	Q10
敌营十八年	敌营十八年
漩涡鸣人	漩涡鸣人
金枝玉叶	金枝玉叶
陈翔六点半	陈翔六点半
十六岁的花季	十六岁的花季
红蜻蜓	红蜻蜓
我是唐伯虎	我是唐伯虎
夏日香气	夏日香气
枪炮侯	枪炮侯
解放浪漫	解放浪漫
小龙人	小龙人
爱在何方	爱在何方
不能没有你	不能没有你
BLANC&ECLARE	BLANC&ECLARE
first love	first love
大上海1937	大上海1937
为人师表	为人师表
向东是大海	向东是大海
甜蜜的伤口	甜蜜的伤口
为记忆呼喊	为记忆呼喊
肥姐挂帅	肥姐挂帅
马医	马医
诺诺	诺诺
星星点灯	星星点灯
江南style	江南style
上有老	上有老
让我叫你一声岳父	让我叫你一声岳父
乱世孤雏	乱世孤雏
斗牛，要不要	斗牛，要不要
宫廷画师郎世宁	宫廷画师郎世宁
美丽背后	美丽背后
李玟暎	李玟暎
请你原谅我	请你原谅我
七夕节	七夕节
花腰新娘	花腰新娘
第三种幸福	第三种幸福
女人花	女人花
你是无情的人	你是无情的人
塔里木河	塔里木河
珠光宝气	珠光宝气
心术	心术
虎侠歼仇	虎侠歼仇
汉密尔顿夫人	汉密尔顿夫人
夫妻天注定	夫妻天注定
妃英理	妃英理
孙武	孙武
喋血青春	喋血青春
老派恋情	老派恋情
香草	香草
化蝶飞	化蝶飞
Crack A Bottle	Crack A Bottle
纳妾记	纳妾记
少年包青天Ⅱ	少年包青天Ⅱ
烽火佳人	烽火佳人
黑叮本	黑叮本
再唱一首歌	再唱一首歌
监视者们	监视者们
爱的根源	爱的根源
金钱之味	金钱之味
灰姑娘的故事	灰姑娘的故事
灰色的彩虹	灰色的彩虹
携枪流浪汉	携枪流浪汉
文豪野犬	文豪野犬
让子弹飞	让子弹飞
地下交通站	地下交通站
u	u
都是天使惹的祸	都是天使惹的祸
我和我的传奇奶奶	我和我的传奇奶奶
甜心战士	甜心战士
with you	with you
冰雨	冰雨
明知道	明知道
老友狗狗	老友狗狗
够钟	够钟
心碎	心碎
anego	anego
猛龙	猛龙
理想的儿子	理想的儿子
乌兰巴托不眠夜	乌兰巴托不眠夜
拉克丝·克莱茵	拉克丝·克莱茵
海上诊疗所	海上诊疗所
假面骑士kiva	假面骑士kiva
孔雀东南飞	孔雀东南飞
犯罪少年	犯罪少年
我们如何说再见	我们如何说再见
美国队长2	美国队长2
老米家的婚事	老米家的婚事
甄嬛传	甄嬛传
纳西情歌	纳西情歌
唱给谁听	唱给谁听
荒野生存	荒野生存
日下部栗	日下部栗
万花迎春	万花迎春
游戏王	游戏王
远离战争年代	远离战争年代
江塘集中营	江塘集中营
女人的村庄	女人的村庄
白雪公主与猎人	白雪公主与猎人
荒野猎人	荒野猎人
翻不完的夏天	翻不完的夏天
死亡诗社	死亡诗社
黑须彼方	黑须彼方
七日间之战争	七日间之战争
祝福	祝福
我为儿孙当北漂	我为儿孙当北漂
绝色神偷	绝色神偷
亲亲老爸	亲亲老爸
初恋的回忆	初恋的回忆
掌心	掌心
老大的婚事	老大的婚事
浏阳河	浏阳河
青年医生	青年医生
糊涂绑架事件	糊涂绑架事件
弗兰奇	弗兰奇
太阳出来喜洋洋	太阳出来喜洋洋
天之大	天之大
痴梦	痴梦
因为爱	因为爱
成长教育	成长教育
北京精神	北京精神
加勒比海盗	加勒比海盗
彷徨之刃	彷徨之刃
幸福恋人	幸福恋人
废柴联盟	废柴联盟
军师联盟	军师联盟
周仁回府	周仁回府
蓝色情人节	蓝色情人节
放开你的心	放开你的心
玉堂春	玉堂春
练胆儿	练胆儿
爱上你了	爱上你了
单身男女	单身男女
格斯	格斯
微微一笑很倾城	微微一笑很倾城
北京City	北京City
神探狄仁杰第二部	神探狄仁杰第二部
战士	战士
不浪漫罪名	不浪漫罪名
樱咲刹那	樱咲刹那
Last song	Last song
华丽的挑战	华丽的挑战
错错错	错错错
红色假期黑色婚礼	红色假期黑色婚礼
国道封闭	国道封闭
我的女友是九尾狐	我的女友是九尾狐
问题餐厅	问题餐厅
Sweet Girl	Sweet Girl
富贵荣华	富贵荣华
天骄	天骄
狱中龙	狱中龙
三轮车夫	三轮车夫
想飞	想飞
单身毒妈	单身毒妈
蜥蜴女孩	蜥蜴女孩
大战泗洲城	大战泗洲城
花仙子	花仙子
全员单恋	全员单恋
下一个天亮	下一个天亮
别让我看见	别让我看见
铁血丹心	铁血丹心
七月寒潮	七月寒潮
我和春天有个约会	我和春天有个约会
舞者	舞者
太阳的后裔	太阳的后裔
草帽警察	草帽警察
天国的嫁衣	天国的嫁衣
倒数第二次恋爱	倒数第二次恋爱
门徒	门徒
吹着风的好日子	吹着风的好日子
光的棍	光的棍
我叫王土地	我叫王土地
oath sign	oath sign
夜袭	夜袭
高跟鞋先生	高跟鞋先生
控制	控制
十七岁	十七岁
爱多少	爱多少
三人世界	三人世界
卓尼土司	卓尼土司
指环王：国王归来	指环王：国王归来
茅山道士	茅山道士
钢铁侠	钢铁侠
给未知恋人的爱情短信	给未知恋人的爱情短信
煤气灯下	煤气灯下
武装女猎人	武装女猎人
舞林大会	舞林大会
一站到底	一站到底
大话西游Ⅱ	大话西游Ⅱ
魔女裁判	魔女裁判
烈日灼心	烈日灼心
北斗双雄	北斗双雄
七月好风	七月好风
男生女生向前走	男生女生向前走
施公奇案Ⅱ	施公奇案Ⅱ
20世纪少年	20世纪少年
疯狂的心	疯狂的心
钢牙	钢牙
执到宝	执到宝
表白	表白
c.c.	c.c.
我是特种兵之利刃出鞘	我是特种兵之利刃出鞘
蓝色的蒙古高原	蓝色的蒙古高原
爱相随	爱相随
让你猜	让你猜
38师机动队	38师机动队
在等待	在等待
恶虎村	恶虎村
维克多·雨果	维克多·雨果
男左女右	男左女右
静夜思	静夜思
落水狗	落水狗
布娃娃	布娃娃
暴雨纪念日	暴雨纪念日
深夜食堂	深夜食堂
阿诗玛	阿诗玛
黑衣人3	黑衣人3
火蝴蝶	火蝴蝶
翻身姐妹	翻身姐妹
不后悔	不后悔
翡翠色的沙滩裙	翡翠色的沙滩裙
遍地狼烟	遍地狼烟
康熙秘史	康熙秘史
Here to stay	Here to stay
意外	意外
春光乍泄	春光乍泄
街上流行红裙子	街上流行红裙子
风中有朵雨做的云	风中有朵雨做的云
大爱如天	大爱如天
濠江风云	濠江风云
风雨无阻	风雨无阻
咸豆浆	咸豆浆
两个女人的战争	两个女人的战争
别无选择	别无选择
叶问3	叶问3
中国式离婚	中国式离婚
破晓	破晓
你是年少的欢喜	你是年少的欢喜
新闻女郎	新闻女郎
美丽上海	美丽上海
星之金币2	星之金币2
桥隆飙	桥隆飙
绝地奶霸3	绝地奶霸3
最依赖的温柔	最依赖的温柔
梦	梦
老牛家的战争	老牛家的战争
耳朵大有福	耳朵大有福
松冈美羽	松冈美羽
谁敢亮剑	谁敢亮剑
唐朝好男人第二部	唐朝好男人第二部
梦想	梦想
诡异录之锁龙井	诡异录之锁龙井
你看不见我	你看不见我
法门寺	法门寺
金蛇狂舞	金蛇狂舞
杯水情歌	杯水情歌
秋之白华	秋之白华
樱桃红之袖珍妈妈	樱桃红之袖珍妈妈
婚姻勿语	婚姻勿语
那年夏天你去了哪里	那年夏天你去了哪里
我不想忘记你	我不想忘记你
新蜀山剑侠	新蜀山剑侠
城市之光	城市之光
拜托小姐	拜托小姐
最后之舞	最后之舞
复活	复活
完美的呻吟	完美的呻吟
找回自己	找回自己
凤凰四重奏	凤凰四重奏
星际精灵蓝多多	星际精灵蓝多多
星梦学园	星梦学园
水姻缘	水姻缘
摩登如来神掌	摩登如来神掌
下一站，幸福	下一站，幸福
乐昌公主	乐昌公主
Going My Home	Going My Home
树大根深	树大根深
江湖告急	江湖告急
蝴蝶夫人	蝴蝶夫人
绿洲	绿洲
至少还有你	至少还有你
无心伤害	无心伤害
布衣天子	布衣天子
穿越烽火线	穿越烽火线
泰山屠龙	泰山屠龙
假如幸福来临	假如幸福来临
旅途	旅途
天降财神	天降财神
盲目的爱情	盲目的爱情
夏日的期待	夏日的期待
高朋满座	高朋满座
22	22
雪候鸟	雪候鸟
圣殇	圣殇
画心	画心
上海之夜	上海之夜
阳光像花一样绽放	阳光像花一样绽放
翡翠凤凰	翡翠凤凰
爱的天空下	爱的天空下
死神来了	死神来了
那年冬天，风在吹	那年冬天，风在吹
dolls	dolls
末日崩塌	末日崩塌
我，机器人	我，机器人
龙飞凤舞	龙飞凤舞
蓝色生死恋	蓝色生死恋
超级星期天	超级星期天
艳阳天	艳阳天
温柔时刻	温柔时刻
序章	序章
雪城穗乃香	雪城穗乃香
mystery	mystery
凶暴的男人	凶暴的男人
永远的0	永远的0
不枉	不枉
证据	证据
追日者	追日者
金田一少年之事件簿	金田一少年之事件簿
爱的主打歌	爱的主打歌
Stop stop it	Stop stop it
你最珍贵	你最珍贵
火锅英雄	火锅英雄
以一敌百	以一敌百
天亮了	天亮了
太行山上	太行山上
I Just Wanna Dance	I Just Wanna Dance
独家披露	独家披露
画影	画影
爱杀17	爱杀17
走过咖啡屋	走过咖啡屋
西游记之真假美猴王	西游记之真假美猴王
就这样散了吧	就这样散了吧
乱世飘萍	乱世飘萍
陷入绝境	陷入绝境
Teenage dream	Teenage dream
日日摇滚	日日摇滚
因为爱情有幸福	因为爱情有幸福
粉爱粉爱你	粉爱粉爱你
秋前算账	秋前算账
马尾与发圈	马尾与发圈
六年之痒	六年之痒
舞动全城	舞动全城
flower	flower
朋友二号	朋友二号
谢谢你让我这么爱你	谢谢你让我这么爱你
不毛地带	不毛地带
精武英雄	精武英雄
看海的日子	看海的日子
活着	活着
单身男子	单身男子
生存之民工	生存之民工
美人心计	美人心计
萤火虫	萤火虫
大侦探福尔摩斯：诡影游戏	大侦探福尔摩斯：诡影游戏
杀死一只知更鸟	杀死一只知更鸟
卡洛德·兰	卡洛德·兰
开创盛世	开创盛世
Mr.Simple	Mr.Simple
毕业季	毕业季
国家宝藏	国家宝藏
有种你爱我	有种你爱我
你是我的生命	你是我的生命
猎影惊魂	猎影惊魂
重案传真	重案传真
璀璨人生	璀璨人生
杨令	杨令
错过了	错过了
九岁县太爷	九岁县太爷
兰陵王妃	兰陵王妃
婵娟误	婵娟误
末路狂花	末路狂花
远野美凪	远野美凪
夜光神杯	夜光神杯
暗夜心慌慌	暗夜心慌慌
爱唱才会赢	爱唱才会赢
A计划	A计划
海神	海神
桃花运	桃花运
淑女夏娃	淑女夏娃
咆哮	咆哮
雅木茶	雅木茶
尼罗河畔的歌声	尼罗河畔的歌声
粉红女郎电影	粉红女郎电影
服部全藏	服部全藏
红十字方队	红十字方队
医龙2	医龙2
全家总动员	全家总动员
安妮·霍尔	安妮·霍尔
你是我的命运	你是我的命运
窃听风暴	窃听风暴
done	done
凄灵室	凄灵室
第四片甲骨	第四片甲骨
不要迷恋姐	不要迷恋姐
十三省	十三省
宝贝小情人	宝贝小情人
放学后福不福	放学后福不福
全世界都恋爱	全世界都恋爱
口是心非	口是心非
我的女儿素英	我的女儿素英
善良的男人	善良的男人
爱我久久	爱我久久
娜娜的玫瑰战争	娜娜的玫瑰战争
我们这里还有鱼	我们这里还有鱼
诡婚	诡婚
杨靖宇将军	杨靖宇将军
恋爱时代	恋爱时代
The show	The show
富贵花开凤凰台	富贵花开凤凰台
半泽直树	半泽直树
可凡倾听	可凡倾听
倾世皇妃	倾世皇妃
那些女人	那些女人
咸猪手爱德华	咸猪手爱德华
辛普森一家	辛普森一家
刀剑神域	刀剑神域
广播岁月	广播岁月
讲不出再见	讲不出再见
拯救大兵瑞恩	拯救大兵瑞恩
京城81号	京城81号
妙手仁心Ⅱ	妙手仁心Ⅱ
静待黎明	静待黎明
妙手仁心Ⅲ	妙手仁心Ⅲ
真爱无悔	真爱无悔
杜鹃的女儿	杜鹃的女儿
离别的纪念	离别的纪念
像眼泪般的人	像眼泪般的人
福熙姐姐	福熙姐姐
非常老爸	非常老爸
楼	楼
原乡	原乡
权力的游戏	权力的游戏
泰坦尼克号	泰坦尼克号
爱的回顾	爱的回顾
食人女	食人女
平凡恋人	平凡恋人
英雄本色	英雄本色
你把我灌醉	你把我灌醉
失忆中等你	失忆中等你
阳光	阳光
凤凰于飞	凤凰于飞
如果	如果
更爱	更爱
恋爱相对论	恋爱相对论
鬼夫	鬼夫
爸爸闭翳	爸爸闭翳
My Love Is Your Love	My Love Is Your Love
肥猫正传	肥猫正传
猫	猫
冬	冬
普通的恋爱	普通的恋爱
爱的阶梯	爱的阶梯
僵尸叔叔	僵尸叔叔
好的事情	好的事情
鹿田九	鹿田九
古城缘	古城缘
李小龙	李小龙
律政新人王	律政新人王
我在天堂等你	我在天堂等你
一夜成名	一夜成名
黄昏界	黄昏界
食客	食客
咆哮无声	咆哮无声
黑桐干也	黑桐干也
攻壳机动队	攻壳机动队
非常保镖	非常保镖
午夜出租车	午夜出租车
莱茵河之恋	莱茵河之恋
再别康桥	再别康桥
苍狼	苍狼
越光宝盒	越光宝盒
龙游天下	龙游天下
七年之痒	七年之痒
未生	未生
火火	火火
灰色轨迹	灰色轨迹
医学团队	医学团队
阿姆罗·雷	阿姆罗·雷
奇葩一家亲	奇葩一家亲
人鱼传说	人鱼传说
你为什么说谎	你为什么说谎
寻秦记	寻秦记
妈妈为我嫁	妈妈为我嫁
何所冬暖，何所夏凉	何所冬暖，何所夏凉
安提戈涅	安提戈涅
第一世家	第一世家
致命ID	致命ID
春寒	春寒
火火的歌谣	火火的歌谣
钱多多嫁人记	钱多多嫁人记
左耳	左耳
Butter-fly	Butter-fly
女仆刑警	女仆刑警
婚礼的祝福	婚礼的祝福
我的甜蜜都市	我的甜蜜都市
旋风十一人	旋风十一人
野鸽子	野鸽子
fine	fine
偏爱	偏爱
恋爱前规则	恋爱前规则
柏拉图童话	柏拉图童话
幽灵情书	幽灵情书
焦土之城	焦土之城
新贵妃醉酒	新贵妃醉酒
一定要爱你	一定要爱你
你我	你我
安妮和安东尼	安妮和安东尼
相约星期二	相约星期二
8	8
蜀山战纪之剑侠传奇	蜀山战纪之剑侠传奇
上海的早晨	上海的早晨
僵尸保镖	僵尸保镖
妈妈也漂亮	妈妈也漂亮
少年包青天	少年包青天
白骨阴阳剑	白骨阴阳剑
与安娜的四个夜晚	与安娜的四个夜晚
国球手	国球手
非常人贩	非常人贩
疯狂的代价	疯狂的代价
下一个奇迹	下一个奇迹
大雨	大雨
恩熙	恩熙
重力小丑	重力小丑
克卜勒	克卜勒
滚滚长江东逝水	滚滚长江东逝水
速度与激情7	速度与激情7
两个人的烟火	两个人的烟火
坏家伙们	坏家伙们
搜索	搜索
我是杀人犯	我是杀人犯
新西厢记	新西厢记
宫锁珠帘	宫锁珠帘
just the way you are	just the way you are
破洪州	破洪州
回家的路	回家的路
雨中的恋人们	雨中的恋人们
濠河边上的女人	濠河边上的女人
危情瘾难耐	危情瘾难耐
艾米加油	艾米加油
霹雳先锋	霹雳先锋
lion	lion
金沙水拍	金沙水拍
红色警戒	红色警戒
雾里玫瑰	雾里玫瑰
神剑魔刀	神剑魔刀
朱丽叶与梁山伯	朱丽叶与梁山伯
我们身边的犯罪	我们身边的犯罪
无贼	无贼
天注定	天注定
dark horse	dark horse
聊斋3之庚娘	聊斋3之庚娘
神仙老爸	神仙老爸
迷离档案	迷离档案
头骨俱乐部	头骨俱乐部
公主小妹	公主小妹
幸福小镇	幸福小镇
第五空间	第五空间
妻子结婚了	妻子结婚了
百万朵玫瑰	百万朵玫瑰
白毛女	白毛女
情断上海滩	情断上海滩
魔幻赌船	魔幻赌船
High School: Love On	High School: Love On
第36个故事	第36个故事
孙膑下山	孙膑下山
柳如是	柳如是
high kick 3	high kick 3
四大名捕会京师	四大名捕会京师
网球王子	网球王子
还珠格格第二部	还珠格格第二部
小热恋	小热恋
蜀山奇侠之紫青双剑	蜀山奇侠之紫青双剑
创可贴	创可贴
无字的情批	无字的情批
指环王：护戒使者	指环王：护戒使者
至少还有一个梦	至少还有一个梦
爱不是要你感激	爱不是要你感激
二炮手	二炮手
怀玉公主	怀玉公主
大城小故事	大城小故事
光之美少女SplashStar	光之美少女SplashStar
杀人者	杀人者
理智与情感	理智与情感
终有一天感动你	终有一天感动你
盘尼西林·1944	盘尼西林·1944
刮目相看	刮目相看
无赖	无赖
安娜·卡列尼娜	安娜·卡列尼娜
女人三十朱冬花	女人三十朱冬花
查理和巧克力工厂	查理和巧克力工厂
水星记	水星记
为爱毁灭	为爱毁灭
闪亮的日子	闪亮的日子
龙形刁手金钟罩	龙形刁手金钟罩
剑河	剑河
花旗少林	花旗少林
黄土高坡	黄土高坡
太阳与海的教室	太阳与海的教室
如果你也听说	如果你也听说
怒江之战	怒江之战
有一个地方只有我们知道	有一个地方只有我们知道
夜行书生	夜行书生
男大当差	男大当差
拯救绿色星球	拯救绿色星球
心甘情愿	心甘情愿
晗羞草	晗羞草
班扎古鲁白玛的沉默	班扎古鲁白玛的沉默
second tune～让世界暂停～	second tune～让世界暂停～
目隐都市的演绎者	目隐都市的演绎者
上弦月	上弦月
从奴隶到将军	从奴隶到将军
千方百计爱上你	千方百计爱上你
珍爱林北	珍爱林北
画壁	画壁
恋爱专家	恋爱专家
雁鸣湖之恋	雁鸣湖之恋
狼的孩子雨和雪	狼的孩子雨和雪
恶女阿楚	恶女阿楚
Talk Dirty	Talk Dirty
城南旧事	城南旧事
唐知县审诰命	唐知县审诰命
女人公敌	女人公敌
被称为早海的日子	被称为早海的日子
深夜的FM	深夜的FM
海南鸡饭	海南鸡饭
刑警本色	刑警本色
吐鲁番的葡萄熟了	吐鲁番的葡萄熟了
明天的喜多善男～世界上最倒霉男人奇迹的11天～	明天的喜多善男～世界上最倒霉男人奇迹的11天～
火烧圆明园	火烧圆明园
窦唯	窦唯
老鼠爱大米	老鼠爱大米
BJ单身日记	BJ单身日记
星梦缘	星梦缘
极道学园	极道学园
时间没有等我	时间没有等我
开往明天的旅行	开往明天的旅行
我是女生	我是女生
一切会好的	一切会好的
篮球火	篮球火
酒店之王	酒店之王
到火花中去	到火花中去
我的宝贝四千金	我的宝贝四千金
握不住的他	握不住的他
老千	老千
神探联盟第二季	神探联盟第二季
如果想念	如果想念
小毕的故事	小毕的故事
美丽鲜花在开放	美丽鲜花在开放
女魔头	女魔头
美国黑帮	美国黑帮
恋人	恋人
产科医生	产科医生
护士站的故事	护士站的故事
奇幻人世间	奇幻人世间
狗镇议员	狗镇议员
美丽的日子	美丽的日子
超萌英雄	超萌英雄
那一世	那一世
超级快递	超级快递
蜀山传	蜀山传
女人唔易做	女人唔易做
旧欢如梦	旧欢如梦
我爱幸运七	我爱幸运七
高地	高地
青丘狐传说	青丘狐传说
我想成为贝壳	我想成为贝壳
在那遥远的地方	在那遥远的地方
7 days	7 days
金山寺	金山寺
情癫大圣	情癫大圣
鬼影	鬼影
十字架	十字架
Just Dance	Just Dance
庆顶珠	庆顶珠
目的地中国	目的地中国
六人晚餐	六人晚餐
驿马车	驿马车
爱，来的刚好	爱，来的刚好
彩虹罗曼史	彩虹罗曼史
新进职员	新进职员
Cheerful Sensibility	Cheerful Sensibility
努力	努力
澄沙之味	澄沙之味
弄臣	弄臣
一个微笑一个你	一个微笑一个你
青梅	青梅
三个奶爸	三个奶爸
爱情魔发师	爱情魔发师
爱情碰碰撞	爱情碰碰撞
女生向前走	女生向前走
特警判官	特警判官
蝴蝶效应	蝴蝶效应
爱在有情天	爱在有情天
宫锁连城	宫锁连城
桂雏菊	桂雏菊
奇男怪女	奇男怪女
北京假日	北京假日
湄公河大案	湄公河大案
最后的格格	最后的格格
传说的教师	传说的教师
阿尔托利亚·潘德拉贡	阿尔托利亚·潘德拉贡
后备空姐	后备空姐
杜十娘	杜十娘
天使的幸福	天使的幸福
直到永远	直到永远
箭士柳白猿	箭士柳白猿
千年等一回	千年等一回
转角遇到爱	转角遇到爱
美食大三通	美食大三通
丑闻	丑闻
你画的彩虹	你画的彩虹
晚宴	晚宴
偏偏喜欢你	偏偏喜欢你
好好拥抱	好好拥抱
big	big
I think I	I think I
南城遗恨	南城遗恨
武林外传	武林外传
目击者	目击者
恋爱满屋之彩虹玫瑰	恋爱满屋之彩虹玫瑰
圣少女	圣少女
不	不
废物老师	废物老师
第一类型危险	第一类型危险
大丈夫	大丈夫
knock	knock
单身情歌	单身情歌
我们无处安放的青春	我们无处安放的青春
音无响子	音无响子
我叫郝聪明之笨蛋爱上两个你	我叫郝聪明之笨蛋爱上两个你
隐私	隐私
魔女18号	魔女18号
色即是空	色即是空
七个女律师	七个女律师
很傻很天真	很傻很天真
我没读书	我没读书
地图上旅行	地图上旅行
只为梦想	只为梦想
军港之夜	军港之夜
简单爱	简单爱
义无反顾	义无反顾
马路须加学园	马路须加学园
饥饿	饥饿
公寓	公寓
你是我的眼睛	你是我的眼睛
现代启示录	现代启示录
我血我情	我血我情
外滩佚事	外滩佚事
亲情树	亲情树
女爵	女爵
古灵精探B	古灵精探B
圣罗兰传	圣罗兰传
恋曲1990	恋曲1990
东方商人	东方商人
唐伯虎点秋香	唐伯虎点秋香
一个人喝醉	一个人喝醉
归去来	归去来
律政佳人	律政佳人
大内密探零零发	大内密探零零发
砂之器	砂之器
飞虎2	飞虎2
坂田银时	坂田银时
龙年警官	龙年警官
映山红	映山红
红色家族	红色家族
朋友别哭	朋友别哭
狄仁杰之通天帝国	狄仁杰之通天帝国
太阳的季节	太阳的季节
汉江怪物	汉江怪物
天使怪盗	天使怪盗
陪你到世界的尽头	陪你到世界的尽头
同事三分亲	同事三分亲
受伤的心	受伤的心
天下粮仓	天下粮仓
原谅我今天	原谅我今天
drama	drama
马利和我	马利和我
Another chance	Another chance
圣公会主学堂	圣公会主学堂
青木瓜之味	青木瓜之味
急诊男女	急诊男女
烈火海洋	烈火海洋
与狼共枕	与狼共枕
善德女王	善德女王
麻辣婚姻之喜事成双	麻辣婚姻之喜事成双
约束の地	约束の地
女王	女王
一个真实的故事	一个真实的故事
一诺千金	一诺千金
立花萤	立花萤
早安晨之美	早安晨之美
X战警：第一战	X战警：第一战
明明说好不哭	明明说好不哭
幽灵党	幽灵党
红色摇篮	红色摇篮
巴基	巴基
绝地花园	绝地花园
那谁	那谁
六天	六天
夜车	夜车
心有千千结	心有千千结
李煜	李煜
月亮上的男人	月亮上的男人
再世红梅记	再世红梅记
sorry sorry	sorry sorry
太阳照常升起	太阳照常升起
建群大业	建群大业
青藏高原	青藏高原
刘胡兰	刘胡兰
你是另一个我	你是另一个我
我的父亲	我的父亲
爱你一生	爱你一生
歌剧魅影	歌剧魅影
龙汇镖局	龙汇镖局
我的答铃	我的答铃
生死时速	生死时速
最后一场电影	最后一场电影
绝不放手	绝不放手
神探伽利略	神探伽利略
孔子春秋	孔子春秋
让我再看你一眼	让我再看你一眼
血债血偿	血债血偿
大雨天	大雨天
火球	火球
小妇人	小妇人
流氓校长	流氓校长
老马家的幸福往事	老马家的幸福往事
风车	风车
纯纯欲动	纯纯欲动
蝴蝶杯	蝴蝶杯
女孩站出来	女孩站出来
青藏铁路	青藏铁路
怎么happy	怎么happy
不让我的眼泪陪我过夜	不让我的眼泪陪我过夜
伤心太平洋	伤心太平洋
侠女游龙	侠女游龙
少爷威威	少爷威威
十七岁的单车	十七岁的单车
Born This Way	Born This Way
围脖时期的爱情	围脖时期的爱情
黄金新娘	黄金新娘
我听说	我听说
忘不了	忘不了
飞雪	飞雪
吞噬太阳	吞噬太阳
安室透	安室透
美国骗局	美国骗局
婆媳过招	婆媳过招
老兵	老兵
irreplaceable	irreplaceable
一起又看流星雨	一起又看流星雨
生意兴隆	生意兴隆
回家过年	回家过年
建筑学概论	建筑学概论
美味学院	美味学院
蝙蝠侠与罗宾	蝙蝠侠与罗宾
玫瑰漩涡	玫瑰漩涡
双面镜	双面镜
蓝色风暴	蓝色风暴
上书房	上书房
交通警察	交通警察
人狗奇缘	人狗奇缘
闻香识女人	闻香识女人
咱们村的年轻人	咱们村的年轻人
爱过你	爱过你
枕边的男人	枕边的男人
秋海棠	秋海棠
四千金	四千金
无法阻挡的婚姻	无法阻挡的婚姻
the next episode	the next episode
约定	约定
尾牌Q1	尾牌Q1
神的天平	神的天平
嗨！亲爱的	嗨！亲爱的
爱我别走	爱我别走
史上最恶约会	史上最恶约会
2005	2005
穿透屋顶的high kick	穿透屋顶的high kick
喜马拉雅王子	喜马拉雅王子
我的团长我的团	我的团长我的团
魔鬼天使	魔鬼天使
看见你的声音	看见你的声音
探灵档案	探灵档案
桑原和真	桑原和真
穿越时空的少女	穿越时空的少女
我的泡沫之夏	我的泡沫之夏
尴尬时刻	尴尬时刻
补天裂	补天裂
四重奏	四重奏
点金胜手	点金胜手
幸福额度	幸福额度
刀光枪影	刀光枪影
孤单又灿烂的神-鬼怪	孤单又灿烂的神-鬼怪
BRIGHT STREAM	BRIGHT STREAM
迟开的玫瑰	迟开的玫瑰
雾之旗	雾之旗
新闻当事人	新闻当事人
蓝色的海	蓝色的海
异星战场	异星战场
木暮公延	木暮公延
美丽传说II星愿	美丽传说II星愿
你就不要想起我	你就不要想起我
空白格	空白格
阿修罗男爵	阿修罗男爵
丁丁历险记：独角兽号的秘密	丁丁历险记：独角兽号的秘密
伪恋	伪恋
军情五处	军情五处
贫民窟的百万富翁	贫民窟的百万富翁
我的初恋男友	我的初恋男友
大江东去	大江东去
蝴蝶梦	蝴蝶梦
饭团之家	饭团之家
关不上的窗	关不上的窗
源代码	源代码
孤独的人是可耻的	孤独的人是可耻的
秀丽江山之长歌行	秀丽江山之长歌行
我也难过	我也难过
男人海洋	男人海洋
No Diggity	No Diggity
夜雨	夜雨
龙少爷	龙少爷
幸运大门	幸运大门
机巧少女不会受伤	机巧少女不会受伤
故乡的云	故乡的云
我未惊过	我未惊过
孝子	孝子
科洛弗档案	科洛弗档案
真心电流	真心电流
海猫	海猫
Love Story	Love Story
你是我的梦	你是我的梦
落雨声	落雨声
母亲	母亲
海猿	海猿
无·果	无·果
一又二分之一的夏天	一又二分之一的夏天
时光正好	时光正好
乱世新娘	乱世新娘
辩护人	辩护人
家和万事兴之幸福的味道	家和万事兴之幸福的味道
喜剧时代	喜剧时代
战无不胜	战无不胜
祈祷	祈祷
Time after time～在落花纷飞的街道上～	Time after time～在落花纷飞的街道上～
夜半歌声	夜半歌声
中国	中国
怪侠一枝梅	怪侠一枝梅
蝴蝶飞飞	蝴蝶飞飞
一路惊喜	一路惊喜
黑鹰坠落	黑鹰坠落
太极张三丰	太极张三丰
未完成的歌	未完成的歌
毒刺	毒刺
米莲·吉那斯	米莲·吉那斯
我与梦露的一周	我与梦露的一周
几度春风几度霜	几度春风几度霜
最终幻想：零式	最终幻想：零式
姐姐立正向前走	姐姐立正向前走
十三格格	十三格格
风之花园	风之花园
心火	心火
墨利斯的情人	墨利斯的情人
透过开满鲜花的月亮	透过开满鲜花的月亮
寒战	寒战
我就是我	我就是我
PHANTOM MINDS	PHANTOM MINDS
仙侠传·雪字	仙侠传·雪字
来的都是客	来的都是客
姐妹花	姐妹花
奶娘	奶娘
春娇与志明	春娇与志明
玉观音	玉观音
刚刚好	刚刚好
战太平	战太平
星期五	星期五
琅琊榜	琅琊榜
风城火情	风城火情
漫长的炎夏	漫长的炎夏
圣德太子	圣德太子
尼罗河上的惨案	尼罗河上的惨案
碟中谍3	碟中谍3
碟中谍2	碟中谍2
团圆	团圆
拳霸	拳霸
综艺大哥大	综艺大哥大
The Hell Song	The Hell Song
狂热	狂热
高宠	高宠
年轮	年轮
特工佳丽	特工佳丽
直到那一天	直到那一天
天地传说之鱼美人	天地传说之鱼美人
黑色皮革手册	黑色皮革手册
青春之火	青春之火
包青天	包青天
方世玉与乾隆皇	方世玉与乾隆皇
那些迷人的往事	那些迷人的往事
S&M	S&M
gimme more	gimme more
黎明绝杀	黎明绝杀
繁星四月	繁星四月
我愿意	我愿意
可喜可贺	可喜可贺
我会很诚实	我会很诚实
夜光藻	夜光藻
蓝色大门	蓝色大门
皇天后土	皇天后土
量贩春光	量贩春光
流氓教授	流氓教授
暗黑者	暗黑者
恐怖直播	恐怖直播
远在眼前的你	远在眼前的你
为你我受冷风吹	为你我受冷风吹
abcd	abcd
城市之夜	城市之夜
载得有情人	载得有情人
宫锁沉香	宫锁沉香
孩奴	孩奴
一千滴眼泪	一千滴眼泪
trap	trap
等你爱我	等你爱我
天国的树	天国的树
山里的石头	山里的石头
我和草原有个约定	我和草原有个约定
南家三姐妹	南家三姐妹
青之时代	青之时代
Girls Just Want To Have Fun	Girls Just Want To Have Fun
成都漂移哥	成都漂移哥
最后的武士	最后的武士
国产凌凌漆	国产凌凌漆
逆袭	逆袭
旧情复炽	旧情复炽
哪吒传奇	哪吒传奇
战地浪漫曲	战地浪漫曲
星际穿越	星际穿越
魔界	魔界
真	真
玛丽亚·凯莉	玛丽亚·凯莉
你说过	你说过
be without you	be without you
爱要撑下去	爱要撑下去
七朵花	七朵花
走路上学	走路上学
党旗颂	党旗颂
紫玫瑰	紫玫瑰
感恩的心	感恩的心
吕不韦传奇	吕不韦传奇
三次结婚的女人	三次结婚的女人
沉默的羔羊	沉默的羔羊
何以笙箫默	何以笙箫默
心仍是冷	心仍是冷
新龙门客栈	新龙门客栈
唱着情歌流着泪	唱着情歌流着泪
僵尸	僵尸
青春期混合曲	青春期混合曲
吴承恩与西游记	吴承恩与西游记
永远的田野	永远的田野
童年时	童年时
王家欣	王家欣
On Call 36小时	On Call 36小时
鲁路修·兰佩路基	鲁路修·兰佩路基
一言难尽	一言难尽
婆媳过招千百回	婆媳过招千百回
人鱼小姐	人鱼小姐
甲方乙方	甲方乙方
生如夏花	生如夏花
穷浪漫	穷浪漫
小孩	小孩
麻雀	麻雀
我知道你去年夏天干了什么	我知道你去年夏天干了什么
爱笑会议室	爱笑会议室
八美图	八美图
不能没有娘	不能没有娘
时效警察	时效警察
QQ爱	QQ爱
土豆最音乐	土豆最音乐
流星蝴蝶剑	流星蝴蝶剑
28岁未成年	28岁未成年
1-4-3	1-4-3
橙路	橙路
静静的	静静的
春分	春分
Good Doctor	Good Doctor
回忆的沙漏	回忆的沙漏
静静的嘛呢石	静静的嘛呢石
right here waiting	right here waiting
Beat it	Beat it
热血男人帮	热血男人帮
极乐岛	极乐岛
数码兽	数码兽
步步惊心：丽	步步惊心：丽
武林猛虎	武林猛虎
童话国	童话国
一树桃花千朵红	一树桃花千朵红
时尚家居	时尚家居
省委书记	省委书记
忠者无敌	忠者无敌
间谍小子	间谍小子
明日话今天	明日话今天
电视剧之王	电视剧之王
新月格格	新月格格
情敌复仇战	情敌复仇战
滇国	滇国
BYE，旧时光	BYE，旧时光
万层浪	万层浪
哑妻	哑妻
红组加油	红组加油
大河颂	大河颂
我的丑娘	我的丑娘
黄浦倾情	黄浦倾情
异国短毛猫	异国短毛猫
听说听说	听说听说
六月虫	六月虫
流星花园	流星花园
巴不得爸爸	巴不得爸爸
亲切的金子	亲切的金子
apologize	apologize
奉旨越狱	奉旨越狱
大清风云	大清风云
烈火雄心Ⅱ	烈火雄心Ⅱ
富豪刑警	富豪刑警
幻影车神：魔盗激情	幻影车神：魔盗激情
马鸣风萧萧	马鸣风萧萧
新娘面具	新娘面具
有一个美丽的地方	有一个美丽的地方
她的神话	她的神话
败犬女王	败犬女王
爱的妇产科2	爱的妇产科2
英雄虎胆	英雄虎胆
岁月风云之上海皇帝	岁月风云之上海皇帝
大香港	大香港
老友记	老友记
活该你单身	活该你单身
拆穿	拆穿
新不了情	新不了情
绝世高手	绝世高手
一世情缘	一世情缘
无敌相师	无敌相师
Jupiter	Jupiter
练霓裳	练霓裳
古剑奇谭之流月昭明	古剑奇谭之流月昭明
冰菓	冰菓
敢死队	敢死队
没有别的爱	没有别的爱
脑男	脑男
frank	frank
嫌疑人X的献身	嫌疑人X的献身
姬宫千歌音	姬宫千歌音
乌龙闯情关	乌龙闯情关
依然爱丽丝	依然爱丽丝
雪山春晓	雪山春晓
相伴永远	相伴永远
大医院小医生	大医院小医生
洪湖赤卫队	洪湖赤卫队
大名顶顶	大名顶顶
惊魂序曲	惊魂序曲
出外人生	出外人生
爱是一颗幸福的子弹	爱是一颗幸福的子弹
依靠	依靠
我要的飞翔	我要的飞翔
一起飞	一起飞
君子协定	君子协定
愈快乐愈堕落	愈快乐愈堕落
金锁记	金锁记
独自等待	独自等待
风愿	风愿
生化危机	生化危机
中国1921	中国1921
玉蝴蝶	玉蝴蝶
走着走着就散了	走着走着就散了
唐菖蒲	唐菖蒲
成长的烦恼	成长的烦恼
代理市长	代理市长
缘	缘
美女孔心	美女孔心
我的自由年代	我的自由年代
过把瘾	过把瘾
课间好时光1年2班	课间好时光1年2班
华胥引之绝爱之城	华胥引之绝爱之城
幻之光	幻之光
少年梁祝	少年梁祝
黑色幽默	黑色幽默
似水流年	似水流年
军医	军医
诛三计	诛三计
造王者	造王者
将来的事	将来的事
赤焰战场2	赤焰战场2
人是铁饭是钢	人是铁饭是钢
美好生活	美好生活
洁子烂漫	洁子烂漫
台儿庄古城	台儿庄古城
就是这个人	就是这个人
铁色高原	铁色高原
我的月光	我的月光
黄河在咆哮	黄河在咆哮
狼爱上羊	狼爱上羊
永远的莉莉亚	永远的莉莉亚
香港艾曼妞	香港艾曼妞
龙咁威2003	龙咁威2003
好好	好好
百万新娘	百万新娘
nobody	nobody
将太的寿司	将太的寿司
青春	青春
傻春	傻春
莫斯科郊外的晚上	莫斯科郊外的晚上
蓝丝绒	蓝丝绒
来自边缘的明信片	来自边缘的明信片
疼你的责任	疼你的责任
Who Are You	Who Are You
明天我要嫁给你	明天我要嫁给你
羞耻	羞耻
偷拐抢骗	偷拐抢骗
大阅兵	大阅兵
像兄妹一样手拉手	像兄妹一样手拉手
还是喜欢你	还是喜欢你
你不是真正的快乐	你不是真正的快乐
锄奸	锄奸
双星情歌	双星情歌
鞭打芦花	鞭打芦花
犽羽獠	犽羽獠
相逢是首歌	相逢是首歌
闲人马大姐	闲人马大姐
左边	左边
Me,Myself,And I	Me,Myself,And I
我	我
笛口雏实	笛口雏实
夏妍的秋天	夏妍的秋天
少林足球	少林足球
过年回家	过年回家
魔女宝鉴	魔女宝鉴
遍体鳞伤	遍体鳞伤
男人就是累	男人就是累
暗恋99天	暗恋99天
四季不败	四季不败
心酸	心酸
秋天别来	秋天别来
架向星空之桥	架向星空之桥
城市·蓝天	城市·蓝天
启程	启程
猎豹出击	猎豹出击
碧云天	碧云天
结城明日奈	结城明日奈
诡劫	诡劫
美丽的神话	美丽的神话
二十四道拐	二十四道拐
叛舰凯恩号	叛舰凯恩号
埴之冢光邦	埴之冢光邦
PRIMA DONNA	PRIMA DONNA
得意的笑	得意的笑
懒猫	懒猫
射天狼	射天狼
卧底	卧底
是错也再不分	是错也再不分
杨过与小龙女	杨过与小龙女
画皮之真爱无悔	画皮之真爱无悔
茶母	茶母
鬼兆	鬼兆
梦中的情话	梦中的情话
父母爱情	父母爱情
活佛济公三	活佛济公三
里约大冒险	里约大冒险
邪完再邪	邪完再邪
和味浓情	和味浓情
前程锦绣	前程锦绣
天阵	天阵
男人不该让女人流泪	男人不该让女人流泪
Mr.Back	Mr.Back
9人禁闭室	9人禁闭室
纸船	纸船
引魂灯	引魂灯
极地雄风	极地雄风
陈圆圆	陈圆圆
画江湖之不良人	画江湖之不良人
你的眼睛背叛你的心	你的眼睛背叛你的心
冰封：重生之门	冰封：重生之门
你的世界	你的世界
火焰驹	火焰驹
狗王擒贼王	狗王擒贼王
失乐园	失乐园
请嫁给我吧	请嫁给我吧
迟早	迟早
血海兄弟	血海兄弟
我爱长发飘飘	我爱长发飘飘
错摸老婆	错摸老婆
高山下的花环	高山下的花环
心理追凶	心理追凶
得到你的人却得不到你的心	得到你的人却得不到你的心
爸爸的3次婚礼	爸爸的3次婚礼
纽约黑帮	纽约黑帮
青年刘伯承	青年刘伯承
天涯赤子心	天涯赤子心
我为喜剧狂	我为喜剧狂
Stories	Stories
狼少女与黑王子	狼少女与黑王子
京华烟云	京华烟云
如果和父亲生活	如果和父亲生活
大武当之天地密码	大武当之天地密码
下雨天	下雨天
情迷彼得堡	情迷彼得堡
大秦帝国之裂变	大秦帝国之裂变
顺流逆流	顺流逆流
蝙蝠侠大战超人：正义黎明	蝙蝠侠大战超人：正义黎明
爷们儿	爷们儿
西藏秘密	西藏秘密
APPLE PIE	APPLE PIE
不良笑花	不良笑花
家族	家族
聊斋夜话	聊斋夜话
我爱他	我爱他
天降	天降
夜访吸血鬼	夜访吸血鬼
雪狼突击	雪狼突击
给力三部曲	给力三部曲
九月的高跟鞋	九月的高跟鞋
卫斯理	卫斯理
竞速之王	竞速之王
here with me	here with me
周仁献嫂	周仁献嫂
斯巴达300	斯巴达300
纠缠一辈子	纠缠一辈子
MUSES DIARY	MUSES DIARY
决战黎明	决战黎明
活着的时光	活着的时光
今夜二十岁	今夜二十岁
举报者	举报者
五味人生	五味人生
如梦	如梦
波丽士大人	波丽士大人
爆漫王。	爆漫王。
笃姬	笃姬
四季	四季
春泥	春泥
你并不懂我	你并不懂我
绕口令	绕口令
神医大道公	神医大道公
比花还美	比花还美
铁人	铁人
金牌男子	金牌男子
美眉校探	美眉校探
寻找伴郎	寻找伴郎
Runaway～为了心爱的你	Runaway～为了心爱的你
纤夫的爱	纤夫的爱
再见自由式	再见自由式
光	光
玉蒲团之偷情宝鉴	玉蒲团之偷情宝鉴
兽王伏魔	兽王伏魔
秀秀的男人	秀秀的男人
归来的黄金福	归来的黄金福
鬼马双星	鬼马双星
寂寞，好了	寂寞，好了
流浪兄弟	流浪兄弟
远山	远山
男才女貌	男才女貌
天道茜	天道茜
爱我的人和我爱的人	爱我的人和我爱的人
The End Of The World	The End Of The World
心在跳	心在跳
爱的言灵	爱的言灵
医学神探	医学神探
假装情侣	假装情侣
坐在巷口的那对男女	坐在巷口的那对男女
贞相大白	贞相大白
拜金女王	拜金女王
我家有个赵大咪	我家有个赵大咪
张衡	张衡
花好月圆	花好月圆
绿光森林	绿光森林
Silent Poor	Silent Poor
我要上春晚	我要上春晚
无间双龙	无间双龙
古宅魅影	古宅魅影
张三其人	张三其人
我是植物人	我是植物人
祝君好	祝君好
中国往事	中国往事
怪医文三块	怪医文三块
青春无悔	青春无悔
唐人街探案	唐人街探案
玫瑰向前开	玫瑰向前开
战地狮吼	战地狮吼
烟花三月	烟花三月
月珑湾之解救武先生	月珑湾之解救武先生
不做花心男	不做花心男
紫雨风暴	紫雨风暴
野兽刑警	野兽刑警
伙头智多星	伙头智多星
我租了一个情人	我租了一个情人
火线	火线
一起奔跑	一起奔跑
规则改变	规则改变
妹妹	妹妹
叉手	叉手
格格要出嫁	格格要出嫁
双头犬	双头犬
爱丫爱丫	爱丫爱丫
佐仓杏子	佐仓杏子
何欲何球	何欲何球
阵头	阵头
从天儿降	从天儿降
海盗	海盗
金梭和银梭	金梭和银梭
乡村爱情小夜曲	乡村爱情小夜曲
下定决心忘记你	下定决心忘记你
逃学威龙	逃学威龙
惊梦	惊梦
喋血1941	喋血1941
自由行走的花	自由行走的花
FIRST CLASS	FIRST CLASS
Crooked	Crooked
男儿本色	男儿本色
girlfriend	girlfriend
码头风云	码头风云
欢乐家庭	欢乐家庭
羊城暗哨	羊城暗哨
京义线	京义线
心的奇迹	心的奇迹
迎春花	迎春花
乾隆大帝	乾隆大帝
刀马旦	刀马旦
凤凰牡丹	凤凰牡丹
星光漫步	星光漫步
蝙蝠侠：侠影之谜	蝙蝠侠：侠影之谜
最后一秒	最后一秒
见字如面	见字如面
最想念的季节	最想念的季节
星星知我心	星星知我心
北极狼	北极狼
希望的奇迹	希望的奇迹
高贵与丑	高贵与丑
百色起义	百色起义
贤内助女王	贤内助女王
倾城	倾城
祝你平安	祝你平安
ALONE	ALONE
钉宫圆	钉宫圆
修理爱	修理爱
没那种命	没那种命
个人取向	个人取向
永别了，武器	永别了，武器
相爱的七种设计	相爱的七种设计
你是谁	你是谁
变色龙	变色龙
鳄鱼潭	鳄鱼潭
Gold Digger	Gold Digger
海豚湾恋人	海豚湾恋人
那样的你	那样的你
危机公关	危机公关
黄金时代	黄金时代
胜女的代价2	胜女的代价2
国徽	国徽
全民公敌	全民公敌
东华春理发厅	东华春理发厅
爱在春天	爱在春天
大秦帝国	大秦帝国
裤甲天下	裤甲天下
钟摆人生	钟摆人生
代号	代号
孽海痴魂	孽海痴魂
Honey Funny Bunny	Honey Funny Bunny
布依姑娘	布依姑娘
远离天堂	远离天堂
三峡好人	三峡好人
我爱喵星人	我爱喵星人
请不要对我说sorry	请不要对我说sorry
生死博弈	生死博弈
相棒	相棒
我要找到你	我要找到你
二胎时代	二胎时代
别再叫我外籍新娘	别再叫我外籍新娘
重版出来！	重版出来！
月光游侠	月光游侠
哇	哇
像中枪一样	像中枪一样
高举·爱	高举·爱
母亲，母亲	母亲，母亲
巴不得妈妈…	巴不得妈妈…
大唐女将樊梨花	大唐女将樊梨花
识骨寻踪	识骨寻踪
媞名	媞名
偶像活动	偶像活动
钱的战争	钱的战争
春天花会开	春天花会开
千里之外	千里之外
LOVE!	LOVE!
非亲姐妹	非亲姐妹
烟雾支柱	烟雾支柱
立秋	立秋
你是我的眼	你是我的眼
幸福了然后呢	幸福了然后呢
方圆几里	方圆几里
天地粮人	天地粮人
阿根廷别为我哭泣	阿根廷别为我哭泣
桂格	桂格
一个月爱情	一个月爱情
主角与配角	主角与配角
巴黎野玫瑰	巴黎野玫瑰
泡泡	泡泡
祝福的钟声	祝福的钟声
两朵大红花	两朵大红花
皇家饭	皇家饭
我是花下肥泥巴	我是花下肥泥巴
那条街	那条街
微爱之渐入佳境	微爱之渐入佳境
萌族酷狗侦探	萌族酷狗侦探
爱情有点蓝	爱情有点蓝
琉球之风	琉球之风
亲亲中国爹娘	亲亲中国爹娘
低俗小说	低俗小说
爱民村官	爱民村官
风起云涌	风起云涌
中国爱	中国爱
流星	流星
FIRST CLASS 2	FIRST CLASS 2
结缘	结缘
我的妹妹哪有这么可爱！	我的妹妹哪有这么可爱！
金耳环	金耳环
情侣	情侣
歌者恋歌	歌者恋歌
大哥你好吗	大哥你好吗
战国	战国
分手要狠	分手要狠
我要变成硬柿子	我要变成硬柿子
那片海	那片海
Single Ladies	Single Ladies
花木兰	花木兰
头师傅一体3	头师傅一体3
圣杯	圣杯
微笑Pasta	微笑Pasta
同心兄弟	同心兄弟
泡沫	泡沫
暗杀教室	暗杀教室
俏女郎	俏女郎
恋爱达人	恋爱达人
月森莲	月森莲
赤道雨	赤道雨
爱要坦荡荡	爱要坦荡荡
澳门风云3	澳门风云3
斯派克·斯皮格尔	斯派克·斯皮格尔
雷雨	雷雨
弹丸飞人	弹丸飞人
假如生活欺骗了你	假如生活欺骗了你
我们生活的年代	我们生活的年代
延安爱情	延安爱情
故园春梦	故园春梦
护国大将军	护国大将军
梁山奇情	梁山奇情
I Wanna Love You Forever	I Wanna Love You Forever
离开雷锋的日子	离开雷锋的日子
西西里的美丽传说	西西里的美丽传说
画中情思	画中情思
真的爱你	真的爱你
海角七号	海角七号
盛世仁杰	盛世仁杰
鲜花盛开的田野	鲜花盛开的田野
我是人	我是人
猎人	猎人
太爱你所以放开你	太爱你所以放开你
一天	一天
恋爱写真	恋爱写真
祖先开眼	祖先开眼
凤凰琴	凤凰琴
最爱你中国	最爱你中国
女帝	女帝
智勇大冲关	智勇大冲关
鲁冰花	鲁冰花
他不懂	他不懂
白事会	白事会
在树上唱歌	在树上唱歌
李祘	李祘
云中漫步	云中漫步
遭遇·阮玲玉	遭遇·阮玲玉
寂寞在唱歌	寂寞在唱歌
墨西哥往事	墨西哥往事
东游记	东游记
梦田	梦田
灵魂摆渡2	灵魂摆渡2
名侦探柯南电视剧特别篇：工藤新一的复活！与黑暗组织的对决	名侦探柯南电视剧特别篇：工藤新一的复活！与黑暗组织的对决
情义	情义
书剑恩仇录	书剑恩仇录
路德维希·凡·贝多芬	路德维希·凡·贝多芬
求婚兄弟～按出生顺序：男人结婚的方法～	求婚兄弟～按出生顺序：男人结婚的方法～
烽火长城	烽火长城
淡淡的歌	淡淡的歌
江湖正道	江湖正道
张之洞	张之洞
大声呼喊你回来	大声呼喊你回来
天才雷普利	天才雷普利
你	你
神仙老师狗	神仙老师狗
思念总在分手后	思念总在分手后
完美广播	完美广播
情书	情书
长不大的爸爸	长不大的爸爸
Give It All Away	Give It All Away
No Air	No Air
魔王	魔王
坐庄	坐庄
我很丑可是我很温柔	我很丑可是我很温柔
流泪的新娘	流泪的新娘
火烧的寂寞	火烧的寂寞
大荒传奇	大荒传奇
21克	21克
初五启市录	初五启市录
张爱玲	张爱玲
情事	情事
含羞草	含羞草
白鲸	白鲸
市政厅	市政厅
很想和你在一起	很想和你在一起
真的好想你	真的好想你
撞球小子	撞球小子
危情24小时	危情24小时
高柏	高柏
李小龙我的兄弟	李小龙我的兄弟
白桦林	白桦林
英雄祭	英雄祭
三个受伤的警察	三个受伤的警察
一米阳光	一米阳光
犯错	犯错
舞女的纯情	舞女的纯情
情人	情人
现场铁证	现场铁证
太极1：从零开始	太极1：从零开始
情陷巴塞罗那	情陷巴塞罗那
夜孔雀	夜孔雀
别爱我	别爱我
运转手之恋	运转手之恋
千秋太后	千秋太后
壹号皇庭	壹号皇庭
爱上女主播	爱上女主播
滚蛋吧！肿瘤君	滚蛋吧！肿瘤君
老外	老外
魔鬼中的天使	魔鬼中的天使
送你葱	送你葱
淘汰	淘汰
关上月光	关上月光
把耳朵叫醒	把耳朵叫醒
一个购物狂的自白	一个购物狂的自白
桥	桥
热血教师	热血教师
HELLO BITCHES	HELLO BITCHES
演员就是演员	演员就是演员
东京日和	东京日和
虎胆龙威5	虎胆龙威5
旧伤口	旧伤口
军统枪口下的女人之潜伏	军统枪口下的女人之潜伏
尖峰时刻Ⅱ	尖峰时刻Ⅱ
榊原恒一	榊原恒一
爱海滔滔	爱海滔滔
冬荫功2：拳霸天下	冬荫功2：拳霸天下
青春无敌之美女时代	青春无敌之美女时代
风和日丽	风和日丽
少年黄飞鸿	少年黄飞鸿
被禁忌的游戏	被禁忌的游戏
西施	西施
茶是故乡浓	茶是故乡浓
幸福时光	幸福时光
摩登保镖	摩登保镖
无法原谅	无法原谅
朝闻天下	朝闻天下
邓涵之	邓涵之
昨迟人	昨迟人
我会在人潮散去等你	我会在人潮散去等你
死亡游戏	死亡游戏
轮回	轮回
26年	26年
山乡情话	山乡情话
标靶	标靶
莎姆雷特	莎姆雷特
魔神英雄传	魔神英雄传
讨人喜欢	讨人喜欢
哇！陈怡君	哇！陈怡君
我心狂野	我心狂野
机动战士高达ZZ	机动战士高达ZZ
十四女英豪	十四女英豪
女人的色彩	女人的色彩
梦回青河	梦回青河
天蚕再变	天蚕再变
什么也不说	什么也不说
吉祥颂	吉祥颂
海军罪案调查处	海军罪案调查处
输了你赢了世界又如何	输了你赢了世界又如何
雪豹	雪豹
孩子王	孩子王
第一次不是你	第一次不是你
栋笃神探	栋笃神探
Another World	Another World
远情	远情
爸爸与小夏	爸爸与小夏
爱的微信	爱的微信
职场之神	职场之神
第二梦	第二梦
梅丽大邱攻防战	梅丽大邱攻防战
家姑	家姑
马永贞	马永贞
雷神	雷神
末代皇帝	末代皇帝
西施秘史	西施秘史
神通	神通
梧桐雨	梧桐雨
蝶恋花	蝶恋花
煤店新工人	煤店新工人
巧克力关系	巧克力关系
筑梦中国	筑梦中国
李小狼	李小狼
怒海情仇	怒海情仇
破茧而声	破茧而声
微时代	微时代
罗曼史	罗曼史
你拿什么来爱我	你拿什么来爱我
blue	blue
姐姐	姐姐
谎言	谎言
最真的梦	最真的梦
见鬼	见鬼
别拿豆包不当干粮	别拿豆包不当干粮
脱轨时代	脱轨时代
主君的太阳	主君的太阳
黑玫瑰	黑玫瑰
神秘的大佛	神秘的大佛
宋庆龄在上海	宋庆龄在上海
烧饼皇后	烧饼皇后
姐妹	姐妹
雪山飞狐	雪山飞狐
岬童夷	岬童夷
爱迪生之母	爱迪生之母
句点	句点
Kissin U	Kissin U
真受伤	真受伤
圣女	圣女
系列	系列
九月九的酒	九月九的酒
舍不得忘记	舍不得忘记
情迷黑森林	情迷黑森林
青春那些事儿	青春那些事儿
2046	2046
voice	voice
风云年代	风云年代
人在旅途洒泪时	人在旅途洒泪时
我的特工女友	我的特工女友
Pieces	Pieces
庙街·妈·兄弟	庙街·妈·兄弟
heartbreaker	heartbreaker
一千年以后	一千年以后
国土安全	国土安全
延安颂	延安颂
曼哈顿爱情故事	曼哈顿爱情故事
碧血盐枭	碧血盐枭
四面夏娃	四面夏娃
大地飞鹰	大地飞鹰
奋斗吧！青春	奋斗吧！青春
王子咖啡店	王子咖啡店
恋爱的发现	恋爱的发现
冒险王	冒险王
我在南宁	我在南宁
闯关东前传	闯关东前传
高护木的规矩	高护木的规矩
智力闯关	智力闯关
豆芽梦	豆芽梦
Star king	Star king
黑洞	黑洞
缺角一族	缺角一族
燃烧吧！火鸟	燃烧吧！火鸟
忘了去懂你	忘了去懂你
东北一家人	东北一家人
虐童疑云	虐童疑云
爱上邓丽君	爱上邓丽君
通天狄仁杰	通天狄仁杰
大悲咒	大悲咒
屈原	屈原
迷离夜	迷离夜
狂野之爱	狂野之爱
开国大典	开国大典
结婚的策略	结婚的策略
梵王宫	梵王宫
千金百分百	千金百分百
想你的笑	想你的笑
恋空	恋空
仁粹大妃	仁粹大妃
烈火战车	烈火战车
逃离德黑兰	逃离德黑兰
你为我着迷	你为我着迷
惊魂记	惊魂记
为爱而生	为爱而生
老枪	老枪
跳	跳
龙凤呈祥	龙凤呈祥
飞虎雄心	飞虎雄心
薪火相传	薪火相传
十送红军	十送红军
疑路邂逅	疑路邂逅
曼谷雨季	曼谷雨季
爱陕北	爱陕北
源氏物语：千年之谜	源氏物语：千年之谜
绝世双骄	绝世双骄
一物降一物	一物降一物
米勒的十字路口	米勒的十字路口
蝴蝶兰	蝴蝶兰
群英会	群英会
杨光的快乐生活	杨光的快乐生活
K-POP最强生死战	K-POP最强生死战
一目连	一目连
决战燕子门	决战燕子门
梅姑	梅姑
黄河谣	黄河谣
我依然爱你	我依然爱你
靓女郎	靓女郎
突然的自我	突然的自我
玻璃舰队	玻璃舰队
我是处女座	我是处女座
my happy ending	my happy ending
北京爱情故事	北京爱情故事
遇上你是我的缘	遇上你是我的缘
幸福满屋	幸福满屋
toxic	toxic
相思雨	相思雨
甜蜜人生	甜蜜人生
无底洞	无底洞
小龙房间里的鱼	小龙房间里的鱼
各显神通	各显神通
来吧	来吧
复仇者联盟2：奥创纪元	复仇者联盟2：奥创纪元
烟雨蒙蒙	烟雨蒙蒙
漕运码头	漕运码头
跟我说爱我	跟我说爱我
好家伙	好家伙
樱桃园	樱桃园
真心真意谢谢你	真心真意谢谢你
星月夜	星月夜
杜丝先生	杜丝先生
房战	房战
恋爱中的宝贝	恋爱中的宝贝
好的情人	好的情人
kiss me	kiss me
完美世界	完美世界
大话西游之月光宝盒	大话西游之月光宝盒
CLANNAD	CLANNAD
旺角黑夜	旺角黑夜
扶不扶	扶不扶
特警冤家	特警冤家
我是丽	我是丽
宫女	宫女
爱情高手	爱情高手
六尺巷	六尺巷
睫毛弯弯	睫毛弯弯
sprout	sprout
亲爱的路人	亲爱的路人
有糖果的陌生人	有糖果的陌生人
错爱一生	错爱一生
财神客栈	财神客栈
情暖玉树	情暖玉树
樱花爱	樱花爱
乱世巨星	乱世巨星
中国人	中国人
半生缘	半生缘
赤子乘龙	赤子乘龙
让每个人都心碎	让每个人都心碎
盘龙卧虎高山顶	盘龙卧虎高山顶
天马座幻想	天马座幻想
姑娘漂亮	姑娘漂亮
Hero	Hero
古宅心慌慌	古宅心慌慌
山那边海那边	山那边海那边
龙在天涯	龙在天涯
男人如衣服	男人如衣服
献给阿尔吉侬的花束	献给阿尔吉侬的花束
客家风云	客家风云
下辈子还嫁给你	下辈子还嫁给你
家政妇三田	家政妇三田
快刀洪吉童	快刀洪吉童
茶花女	茶花女
柏林	柏林
看电视	看电视
衣柜里的男人	衣柜里的男人
牙狼GARO	牙狼GARO
没撑伞的蝼蚁们	没撑伞的蝼蚁们
时间规划局	时间规划局
步伐不停	步伐不停
新结婚时代	新结婚时代
相遇就是缘	相遇就是缘
不准哭	不准哭
灵魂摆渡	灵魂摆渡
阿嬷的话	阿嬷的话
殴打诱发者	殴打诱发者
双刺	双刺
小小新娘花	小小新娘花
非缘勿扰	非缘勿扰
Perfect Man	Perfect Man
疯狂的麦克斯：狂暴之路	疯狂的麦克斯：狂暴之路
济公活佛	济公活佛
爱不单行	爱不单行
将军令	将军令
突然想起你	突然想起你
东京食尸鬼	东京食尸鬼
明日新闻	明日新闻
外星神犬	外星神犬
石头记	石头记
程咬金	程咬金
鼹鼠之歌	鼹鼠之歌
大宅门	大宅门
女神异闻录5	女神异闻录5
一生有你有我	一生有你有我
凡人歌	凡人歌
创业	创业
伤心歌手	伤心歌手
一枝梅	一枝梅
猎杀红色十月号	猎杀红色十月号
Fall In Love	Fall In Love
恋爱症候群	恋爱症候群
冒牌天神2	冒牌天神2
迁徙	迁徙
别爱陌生人	别爱陌生人
不是不想嫁	不是不想嫁
新妓生传	新妓生传
青春大爆炸	青春大爆炸
吴王悲歌	吴王悲歌
天天想着你	天天想着你
绝代佳人	绝代佳人
不肯去观音	不肯去观音
汉宫怨	汉宫怨
我曾经那么接近幸福	我曾经那么接近幸福
守婚	守婚
龙崎堇	龙崎堇
好想	好想
女朋友要带回家	女朋友要带回家
即溶爱人	即溶爱人
蝙蝠侠：黑暗骑士	蝙蝠侠：黑暗骑士
太阳不西沉	太阳不西沉
泪痕剑	泪痕剑
金玉盟	金玉盟
功夫熊猫	功夫熊猫
质量保证班zero	质量保证班zero
恶之教典	恶之教典
小鼓大戏	小鼓大戏
欢喜密探	欢喜密探
爱情花园	爱情花园
恋爱操作团：Cyrano	恋爱操作团：Cyrano
小姐好白	小姐好白
天下第一媒婆	天下第一媒婆
泰熙慧乔智贤	泰熙慧乔智贤
少年四大名捕	少年四大名捕
温柔乡	温柔乡
牛虻	牛虻
The Baddest Female	The Baddest Female
白蛇传	白蛇传
大好河山	大好河山
欲言又止	欲言又止
牛郎织女	牛郎织女
昨日梦已远	昨日梦已远
水蜜桃挽歌	水蜜桃挽歌
武动乾坤	武动乾坤
猎犬	猎犬
法网狙击	法网狙击
热血码头	热血码头
像风一样行走	像风一样行走
九龙传说	九龙传说
马耳他之鹰	马耳他之鹰
万水千山	万水千山
女帅男兵	女帅男兵
Mamacita	Mamacita
胭脂泪	胭脂泪
花千骨	花千骨
活色生香	活色生香
各自远扬	各自远扬
stupid boy	stupid boy
盖世豪侠	盖世豪侠
We Found Love	We Found Love
北上广依然相信爱情	北上广依然相信爱情
我在深圳等你	我在深圳等你
亲爱的祖国	亲爱的祖国
天地男儿	天地男儿
变心的翅膀	变心的翅膀
党的女儿	党的女儿
这，就是爱	这，就是爱
离歌	离歌
多情竹织鸭	多情竹织鸭
银河解放战线	银河解放战线
笑笑茶楼	笑笑茶楼
人间四月天	人间四月天
青春时代	青春时代
潜行狙击	潜行狙击
我是主妇	我是主妇
青春旋律	青春旋律
致命名单	致命名单
绝爱	绝爱
隋唐英雄	隋唐英雄
逃狱雪冤	逃狱雪冤
纽约行动	纽约行动
铁手无情	铁手无情
Confession	Confession
如来神掌	如来神掌
天乩之白蛇传说	天乩之白蛇传说
剪刀手爱德华	剪刀手爱德华
赤道	赤道
如此照相	如此照相
美丽中国	美丽中国
马达加斯加的企鹅	马达加斯加的企鹅
我亲爱的	我亲爱的
花木水	花木水
鉴证实录	鉴证实录
成名在望	成名在望
我猜我猜我猜猜猜	我猜我猜我猜猜猜
花亭相会	花亭相会
麻烦家族	麻烦家族
终极一家	终极一家
七剑下天山	七剑下天山
真实的世界	真实的世界
叶子红了	叶子红了
NO.X	NO.X
金刚狼2	金刚狼2
东风雨	东风雨
趁早	趁早
永恒的光辉	永恒的光辉
我要回家	我要回家
图雅的婚事	图雅的婚事
末路姐妹	末路姐妹
刻骨铭心	刻骨铭心
不屈的儿媳们	不屈的儿媳们
一八九四·甲午大海战	一八九四·甲午大海战
铁将军阿贵	铁将军阿贵
张小觉很自觉	张小觉很自觉
萍聚	萍聚
青春检察官	青春检察官
闯上海	闯上海
新女性	新女性
恶作剧2吻	恶作剧2吻
寂寞来了怎么办	寂寞来了怎么办
最后一班地铁	最后一班地铁
人狼游戏3：狂狐	人狼游戏3：狂狐
贫嘴张大民的幸福生活	贫嘴张大民的幸福生活
跨国追逃	跨国追逃
寒夜	寒夜
秋蝉	秋蝉
flow	flow
昨夜星辰	昨夜星辰
我是演说家	我是演说家
龙兄虎弟	龙兄虎弟
正牌韦小宝之奉旨沟女	正牌韦小宝之奉旨沟女
绝对控制	绝对控制
学聋哑	学聋哑
断刺	断刺
红尘叹	红尘叹
午餐的敦子	午餐的敦子
风中的我对你说	风中的我对你说
乌龙山伯爵	乌龙山伯爵
冰人四万年	冰人四万年
红玫瑰与白玫瑰	红玫瑰与白玫瑰
记忆中的风琴	记忆中的风琴
公安局长	公安局长
哥唱的是寂寞	哥唱的是寂寞
女大学生宿舍	女大学生宿舍
新娘15岁	新娘15岁
会有天使替我爱你	会有天使替我爱你
神偷奶爸	神偷奶爸
梁祝	梁祝
雨后天空	雨后天空
爱LOVE	爱LOVE
凯旋在子夜	凯旋在子夜
疯狂的石头	疯狂的石头
原来有你	原来有你
我在等你	我在等你
费城故事	费城故事
我容易吗	我容易吗
滇西往事	滇西往事
西雅图夜未眠	西雅图夜未眠
c小调第五交响曲	c小调第五交响曲
锋刃	锋刃
我的中国芯	我的中国芯
你到底爱不爱我	你到底爱不爱我
杜兰朵公主	杜兰朵公主
阿娘使道传	阿娘使道传
阿莲	阿莲
感情8号线	感情8号线
东周列国	东周列国
天地记	天地记
仙林青梅	仙林青梅
花非花	花非花
苍星石	苍星石
B计划	B计划
深宫谍影	深宫谍影
漂亮妈妈	漂亮妈妈
新封神榜	新封神榜
锦绣未央	锦绣未央
陪你一起老	陪你一起老
我人生的黄金期	我人生的黄金期
澡堂老板家的男人们	澡堂老板家的男人们
99次心动计划	99次心动计划
花前月下	花前月下
automatic	automatic
黑色香水	黑色香水
音乐剧	音乐剧
你要的爱	你要的爱
最好的时光	最好的时光
公主日记2：皇室婚约	公主日记2：皇室婚约
忽然想到你	忽然想到你
老手	老手
叩叩	叩叩
压岁钱	压岁钱
阿散井恋次	阿散井恋次
黑梦	黑梦
街市的童话	街市的童话
女王办公室	女王办公室
8又二分之一	8又二分之一
当你牵着我的手	当你牵着我的手
阁楼男女	阁楼男女
小生护驾	小生护驾
与歌同行	与歌同行
苗翠花	苗翠花
超时空甩尾	超时空甩尾
我爱钟无艳	我爱钟无艳
老爸老妈的浪漫史	老爸老妈的浪漫史
醒世媳妇	醒世媳妇
桑桑和小猫	桑桑和小猫
野花	野花
七仙女	七仙女
其实我们都寂寞	其实我们都寂寞
LOVE	LOVE
米歇尔维潘	米歇尔维潘
大唐荣耀Ⅱ	大唐荣耀Ⅱ
阿弥陀堂讯息	阿弥陀堂讯息
让我一次爱个够	让我一次爱个够
宙斯之子：赫拉克勒斯	宙斯之子：赫拉克勒斯
拜托了双子星	拜托了双子星
珍珠翡翠白玉汤	珍珠翡翠白玉汤
乱马1/2	乱马1/2
就让你走	就让你走
真实魔鬼游戏4	真实魔鬼游戏4
蝴蝶君	蝴蝶君
咖啡里的泪	咖啡里的泪
我脑海中的橡皮擦	我脑海中的橡皮擦
致我们终将逝去的青春	致我们终将逝去的青春
五鼠闹东京	五鼠闹东京
低头不见抬头见	低头不见抬头见
套马杆	套马杆
爱情邮局	爱情邮局
摩登时代	摩登时代
龙潭夺宝	龙潭夺宝
狱中花	狱中花
黄飞鸿	黄飞鸿
强心脏	强心脏
好男人的秘密武器	好男人的秘密武器
东方朔	东方朔
新白娘子传奇	新白娘子传奇
好儿好女好江山	好儿好女好江山
偷心	偷心
大空头	大空头
bingo	bingo
镖客	镖客
向阳照相馆	向阳照相馆
澳门风云2	澳门风云2
黑炮事件	黑炮事件
我和僵尸有个约会	我和僵尸有个约会
信札疑云	信札疑云
北京夏天	北京夏天
咱家那些事	咱家那些事
女机械人	女机械人
武馆	武馆
执着	执着
奇皇后	奇皇后
百兽战队	百兽战队
Doctor-Y~外科医·加地秀树	Doctor-Y~外科医·加地秀树
钢琴教师	钢琴教师
涨潮海岸	涨潮海岸
小煞星	小煞星
珍惜青春	珍惜青春
血色星期一	血色星期一
汉口码头	汉口码头
三日刺杀	三日刺杀
初恋这件小事	初恋这件小事
来	来
东京少女	东京少女
又是三更，念一个人	又是三更，念一个人
Ma Girl	Ma Girl
恋爱蜜令	恋爱蜜令
黄金鱼	黄金鱼
爱得太迟	爱得太迟
阿良良木历	阿良良木历
小棉袄	小棉袄
美美哒	美美哒
棠棣之花	棠棣之花
恐怖在线	恐怖在线
蒙娜丽莎的眼泪	蒙娜丽莎的眼泪
刺客聂隐娘	刺客聂隐娘
寂寞的十七岁	寂寞的十七岁
饮酒歌	饮酒歌
封神榜	封神榜
生死兄弟之钢魂	生死兄弟之钢魂
小魔女DoReMi	小魔女DoReMi
古老的大钟	古老的大钟
买凶拍人	买凶拍人
项羽	项羽
中毒	中毒
逆流的泪	逆流的泪
格林兄弟	格林兄弟
一人有一个梦想	一人有一个梦想
我的亿万面包	我的亿万面包
赌王风云	赌王风云
妻子的资格	妻子的资格
一路逆风	一路逆风
名门暗战	名门暗战
闹天宫	闹天宫
Little DJ：两小无猜	Little DJ：两小无猜
思美人	思美人
太委屈	太委屈
生命中的精灵	生命中的精灵
爱情来了	爱情来了
恋上你的床	恋上你的床
听得见吗	听得见吗
走过幸福	走过幸福
错误的相遇	错误的相遇
绝世好爸	绝世好爸
生命狂想曲	生命狂想曲
南征北战	南征北战
大话西游之爱你一万年	大话西游之爱你一万年
谁说我们不会爱	谁说我们不会爱
开心华之里	开心华之里
聊斋志异2	聊斋志异2
我欲为人	我欲为人
发烧	发烧
爸爸去哪儿	爸爸去哪儿
锁麟囊	锁麟囊
重击	重击
我爱你	我爱你
星际迷航：暗黑无界	星际迷航：暗黑无界
大变局之梦回甲午	大变局之梦回甲午
血沃油山	血沃油山
A频道	A频道
北京遇上西雅图	北京遇上西雅图
男人离婚	男人离婚
警察故事2013	警察故事2013
望乡	望乡
美国队长	美国队长
鸳鸯绑匪	鸳鸯绑匪
双喜	双喜
生死对峙	生死对峙
欢天喜地七仙女	欢天喜地七仙女
非你不可	非你不可
张思德	张思德
惊变	惊变
斐济99°C爱情	斐济99°C爱情
X战警前传	X战警前传
红高粱	红高粱
孩子们都很好	孩子们都很好
crossing field	crossing field
暗恋桃花源	暗恋桃花源
潜行吧！奈亚子	潜行吧！奈亚子
MTBD	MTBD
地道战	地道战
闯码头	闯码头
熊吉	熊吉
爱情故事	爱情故事
心里的声音	心里的声音
逍遥津	逍遥津
S日记	S日记
钱学森	钱学森
哪吒	哪吒
亲密治疗	亲密治疗
那天	那天
赤裸羔羊	赤裸羔羊
将·军	将·军
恋爱刺客	恋爱刺客
咖啡王子1号店	咖啡王子1号店
怪谈：三岛屋奇异百物语	怪谈：三岛屋奇异百物语
无考不成冤家	无考不成冤家
俏皮女学生	俏皮女学生
初体验	初体验
红旗万年飘	红旗万年飘
擦枪走火	擦枪走火
高跟鞋	高跟鞋
逆袭之星途璀璨	逆袭之星途璀璨
那样芬芳	那样芬芳
贵族侦探	贵族侦探
VOGUE	VOGUE
死亡塔	死亡塔
54	54
我为卿狂	我为卿狂
恋上你，爱上我	恋上你，爱上我
剑心	剑心
飞向别人的床	飞向别人的床
风雨桃花镇	风雨桃花镇
飞砂风中转	飞砂风中转
永不磨灭的番号	永不磨灭的番号
西游记	西游记
我的排队情人	我的排队情人
国家公诉	国家公诉
逆光之恋	逆光之恋
想为你做的	想为你做的
血色玫瑰	血色玫瑰
男孩别哭	男孩别哭
我想静静	我想静静
我的真假王子	我的真假王子
夜光的阶梯	夜光的阶梯
行X踏错	行X踏错
开始恋爱	开始恋爱
我的深情为你守候	我的深情为你守候
别偷我的菜	别偷我的菜
致命赏金	致命赏金
孤女恋	孤女恋
谜城	谜城
Champagne	Champagne
凤凰古城	凤凰古城
守卫者	守卫者
魔法老师	魔法老师
惊世新娘	惊世新娘
佐罗	佐罗
怪物小王子	怪物小王子
野火春风斗古城	野火春风斗古城
皆大欢喜	皆大欢喜
父后七日	父后七日
宝石宠物	宝石宠物
医馆笑传	医馆笑传
看透爱情看透你	看透爱情看透你
泡菜奶酪微笑	泡菜奶酪微笑
盖世英雄方世玉	盖世英雄方世玉
海上风云记	海上风云记
画皮Ⅱ	画皮Ⅱ
罗丹的情人	罗丹的情人
二十四城记	二十四城记
双虎屠龙	双虎屠龙
关于爱情和那些魔鬼	关于爱情和那些魔鬼
米迦勒之舞	米迦勒之舞
美少女啦啦队	美少女啦啦队
四眼仔	四眼仔
娘子写	娘子写
无人喝彩	无人喝彩
非你莫属	非你莫属
体热	体热
那片星空那片海	那片星空那片海
爱情谁也挡不住	爱情谁也挡不住
亚洲雄风	亚洲雄风
我爱男闺蜜	我爱男闺蜜
独家录制	独家录制
真爱无敌	真爱无敌
命运	命运
H2	H2
卧虎藏龙	卧虎藏龙
全世界你最疼我	全世界你最疼我
A Moment Like This	A Moment Like This
超级教师	超级教师
鸣梁海战	鸣梁海战
I don't care	I don't care
流年	流年
爱上单眼皮男生	爱上单眼皮男生
冷暖自知	冷暖自知
我的爱在我身边	我的爱在我身边
爱到底	爱到底
花样少年少女	花样少年少女
谁家灶头无烟火	谁家灶头无烟火
离开我	离开我
婚活刑警	婚活刑警
白夜行	白夜行
红苹果乐园	红苹果乐园
花开半夏	花开半夏
女人四十	女人四十
小智	小智
武林世家	武林世家
月球	月球
血战钢锯岭	血战钢锯岭
谈情说爱	谈情说爱
太阳浴血记	太阳浴血记
朝5晚9~帅气和尚爱上我~	朝5晚9~帅气和尚爱上我~
杨德财征婚	杨德财征婚
爱在他乡的季节	爱在他乡的季节
盗信情缘	盗信情缘
疯岳撬佳人	疯岳撬佳人
月琴	月琴
的士飙花	的士飙花
火蓝刀锋	火蓝刀锋
铁男	铁男
转山	转山
带一片风景走	带一片风景走
月牙儿	月牙儿
春潮	春潮
爱火情仇	爱火情仇
会笑的昨天	会笑的昨天
still in love	still in love
左眼皮跳跳	左眼皮跳跳
兽性新人类	兽性新人类
爱之旅	爱之旅
二千年之恋	二千年之恋
妻妾成群	妻妾成群
廉政追缉令	廉政追缉令
瞧这一家子	瞧这一家子
大旗英雄传	大旗英雄传
少林问道	少林问道
念念	念念
飞哥大英雄	飞哥大英雄
大和拜金女	大和拜金女
梦萦轩辕	梦萦轩辕
香气	香气
孤胆特工	孤胆特工
话说夏娃	话说夏娃
鳄鱼泪	鳄鱼泪
如果爱	如果爱
一年十班	一年十班
一江春水向东流	一江春水向东流
分手说爱你	分手说爱你
双生花	双生花
高意识系男子	高意识系男子
tell me	tell me
黑天鹅	黑天鹅
北京青年	北京青年
江姐	江姐
恋恋书中人	恋恋书中人
封门诡影	封门诡影
阿斯兰·萨拉	阿斯兰·萨拉
爱盛开	爱盛开
乱世红颜	乱世红颜
梅里雪山的女儿	梅里雪山的女儿
江湖侠侣	江湖侠侣
莫非，这就是爱情	莫非，这就是爱情
念亲恩	念亲恩
远去的日子	远去的日子
无所谓	无所谓
凤求凰	凤求凰
你怎么舍得我难过	你怎么舍得我难过
越境	越境
evergreen	evergreen
千年之爱	千年之爱
陈真	陈真
我的青春高八度	我的青春高八度
下雪的日子	下雪的日子
而立之年	而立之年
青空呐喊	青空呐喊
平行理论	平行理论
百花赠剑	百花赠剑
东京金盏花	东京金盏花
从河底问好	从河底问好
香帅传奇	香帅传奇
青春不够用	青春不够用
欢喜冤家	欢喜冤家
再见阿郎	再见阿郎
归国留学生	归国留学生
关中刀客	关中刀客
功夫之王	功夫之王
如果我可以	如果我可以
龙之泪	龙之泪
忠臣蔵外传之四谷怪谈	忠臣蔵外传之四谷怪谈
九龙佩	九龙佩
出轨	出轨
疯狂金车	疯狂金车
爱之歌	爱之歌
卧薪尝胆	卧薪尝胆
打金砖	打金砖
开天辟地	开天辟地
如果难过	如果难过
缺宅男女	缺宅男女
红番区	红番区
看得见风景的房间	看得见风景的房间
律政狂鲨	律政狂鲨
莲花	莲花
来不及说我爱你	来不及说我爱你
最佳情侣	最佳情侣
艺术家	艺术家
爱情闯进门	爱情闯进门
蝴蝶行动	蝴蝶行动
鸣凤之死	鸣凤之死
比翼双飞	比翼双飞
超级访问	超级访问
再见青春	再见青春
美少年之恋	美少年之恋
大峰祖师	大峰祖师
家庭教师HITMAN REBORN!	家庭教师HITMAN REBORN!
不可思异	不可思异
兰花劫	兰花劫
司马迁	司马迁
户冢彩加	户冢彩加
华尔街：金钱永不眠	华尔街：金钱永不眠
谢尔盖·斯米诺夫	谢尔盖·斯米诺夫
第一次爱的人	第一次爱的人
两个巡逻兵	两个巡逻兵
美国超级模特新秀大赛	美国超级模特新秀大赛
祝福祖国	祝福祖国
傲骨贤妻	傲骨贤妻
少女大盗	少女大盗
Danger	Danger
穿越丛林	穿越丛林
如果爱忘了	如果爱忘了
那一年的幸福时光	那一年的幸福时光
杀杀人，跳跳舞	杀杀人，跳跳舞
大戏法	大戏法
摩斯汉堡	摩斯汉堡
林冲夜奔	林冲夜奔
开心鬼精灵	开心鬼精灵
黛比的幸福生活	黛比的幸福生活
芋虫	芋虫
光海，成为王的男人	光海，成为王的男人
伤不起	伤不起
only one	only one
厌倦寂寞	厌倦寂寞
英雄本色3：夕阳之歌	英雄本色3：夕阳之歌
背影	背影
名捕震关东	名捕震关东
皮卡丘	皮卡丘
九家之书	九家之书
地狱少女	地狱少女
步步杀机	步步杀机
猜拳	猜拳
大唐双龙传之长生诀	大唐双龙传之长生诀
杨贵妃秘史	杨贵妃秘史
爱的咒语	爱的咒语
古村女人	古村女人
娜写年华	娜写年华
心急人上	心急人上
虎与龙	虎与龙
警界无声	警界无声
可爱先生	可爱先生
你是我所有的回忆	你是我所有的回忆
Free Somebody	Free Somebody
明星危情	明星危情
缺口	缺口
李香君	李香君
BABY SISTER	BABY SISTER
打牌论	打牌论
当泪流干的时候	当泪流干的时候
毒战	毒战
青叶城之恋	青叶城之恋
sk8er boi	sk8er boi
绿城	绿城
辣手警花	辣手警花
匿名侦探2	匿名侦探2
if i ain't got you	if i ain't got you
向坂环	向坂环
神香	神香
海之恋	海之恋
济公	济公
舞法自拔	舞法自拔
凛凛	凛凛
搏击手	搏击手
倾城绝恋	倾城绝恋
HURT	HURT
封门村	封门村
阿嫂传奇	阿嫂传奇
吕后传奇	吕后传奇
边城浪子	边城浪子
男人的故事	男人的故事
地狱天使	地狱天使
惜别的海岸	惜别的海岸
真相的背后	真相的背后
台湾红不让	台湾红不让
大村官	大村官
X女特工	X女特工
富贵在天	富贵在天
小恶魔ageha	小恶魔ageha
爱你十分泪七分	爱你十分泪七分
甜言蜜语	甜言蜜语
爱上离婚的女人	爱上离婚的女人
I'm All About You	I'm All About You
畸人艳妇	畸人艳妇
葬礼	葬礼
咱老百姓	咱老百姓
小镇姑娘	小镇姑娘
赛车风云	赛车风云
武神赵子龙	武神赵子龙
网上有情人	网上有情人
摇摆少女	摇摆少女
爱蒙住我的眼	爱蒙住我的眼
会痛的17岁	会痛的17岁
三面形医	三面形医
大漠枪神	大漠枪神
笑看风云	笑看风云
三少爷的剑	三少爷的剑
放手2012	放手2012
山西	山西
第8号当铺	第8号当铺
我的“狐朋狗友”	我的“狐朋狗友”
狩猎	狩猎
节振国传奇	节振国传奇
纳尼亚传奇：狮子、女巫和魔衣柜	纳尼亚传奇：狮子、女巫和魔衣柜
相送	相送
Kanon	Kanon
蓝盐	蓝盐
纽约风暴	纽约风暴
鸢	鸢
吕梁英雄传	吕梁英雄传
蔓延	蔓延
长靴妖姬	长靴妖姬
浑身是劲	浑身是劲
钱的化身	钱的化身
别再问我什么是迪斯科	别再问我什么是迪斯科
霸王花	霸王花
楼兰姑娘	楼兰姑娘
同逃幸运儿	同逃幸运儿
赤的冲击	赤的冲击
青山绿水红日子	青山绿水红日子
狼与香辛料	狼与香辛料
南龙北凤	南龙北凤
苍天有泪	苍天有泪
沙西米	沙西米
肥龙过江	肥龙过江
杀手阿一	杀手阿一
王大花的革命生涯	王大花的革命生涯
师父出马	师父出马
人鱼帝国	人鱼帝国
太贪心	太贪心
绝命派对	绝命派对
风云雄霸天下	风云雄霸天下
新编辑部故事	新编辑部故事
综艺最爱宪	综艺最爱宪
我一直都在	我一直都在
大木博士	大木博士
卡缪·比丹	卡缪·比丹
梦里花落知多少	梦里花落知多少
一生为你感动	一生为你感动
完美情人	完美情人
料理仙姬	料理仙姬
那些年，我们一起追的女孩。	那些年，我们一起追的女孩。
窈窕淑女	窈窕淑女
火舞黄沙	火舞黄沙
半路夫妻	半路夫妻
失惊无神	失惊无神
和空姐一起的日子	和空姐一起的日子
18禁不禁	18禁不禁
下个，路口，见	下个，路口，见
王中王	王中王
死神	死神
仙女湖之墨仙	仙女湖之墨仙
十分爱	十分爱
安娜斯塔西娅	安娜斯塔西娅
无味神探	无味神探
渐行渐远	渐行渐远
火烧红莲寺	火烧红莲寺
大决战2：淮海战役	大决战2：淮海战役
创世纪	创世纪
关人7事	关人7事
不忠	不忠
加勒比海盗：惊涛怪浪	加勒比海盗：惊涛怪浪
感应	感应
爱到花开	爱到花开
搞定岳父大人	搞定岳父大人
看见天堂	看见天堂
由乃	由乃
审死官	审死官
Crazy Stupid Love	Crazy Stupid Love
寅次郎的故事	寅次郎的故事
没离开过	没离开过
一个人的遭遇	一个人的遭遇
一门三司令	一门三司令
我真的受伤了	我真的受伤了
遇到真爱	遇到真爱
世界奇妙物语2012年秋季特别篇	世界奇妙物语2012年秋季特别篇
望夫成龙	望夫成龙
电影	电影
可不可以不勇敢	可不可以不勇敢
红领巾	红领巾
盛夏晚晴天	盛夏晚晴天
给自己的信	给自己的信
急诊室的故事	急诊室的故事
最美的时光	最美的时光
开脑儆探	开脑儆探
I'm Sorry	I'm Sorry
亲密爱人	亲密爱人
我的大旧横财	我的大旧横财
匿名侦探	匿名侦探
洪羊洞	洪羊洞
活着VIVA	活着VIVA
刀锋1937	刀锋1937
无尽的爱	无尽的爱
朱元璋	朱元璋
占领西门町	占领西门町
公主保护计划	公主保护计划
幸福谣	幸福谣
平方根	平方根
特殊身份	特殊身份
我说过要你快乐	我说过要你快乐
glamorous sky	glamorous sky
不能结婚的男人	不能结婚的男人
新套马杆	新套马杆
新恋爱经	新恋爱经
Rally Go Round	Rally Go Round
特殊使命	特殊使命
the night is still young	the night is still young
忧郁童话	忧郁童话
X-MAN	X-MAN
家变	家变
生化危机5：惩罚	生化危机5：惩罚
恶魔少爷别吻我第二季	恶魔少爷别吻我第二季
无家可归的小孩2	无家可归的小孩2
明朗少女成功记	明朗少女成功记
木棉袈裟	木棉袈裟
生命至爱	生命至爱
触动	触动
sunrise	sunrise
月光下，我记得	月光下，我记得
最佳拍档	最佳拍档
Now And Forever	Now And Forever
我的简历	我的简历
变身超人	变身超人
第一桶金	第一桶金
忠贞	忠贞
完美超越	完美超越
烈火青春	烈火青春
芦花	芦花
水墨青春	水墨青春
清洁	清洁
看我的	看我的
小巷总理	小巷总理
无敌县令	无敌县令
oasis	oasis
come together	come together
暴走潜龙	暴走潜龙
街	街
我的老婆是大佬	我的老婆是大佬
情定七月天	情定七月天
川藏路	川藏路
情深深雨濛濛	情深深雨濛濛
回归者	回归者
闯关东中篇	闯关东中篇
野蛮少女	野蛮少女
说唱脸谱	说唱脸谱
烟雨凄迷	烟雨凄迷
狼图腾	狼图腾
胡越的故事	胡越的故事
敬仰吾师	敬仰吾师
魔王勇者	魔王勇者
骗中骗	骗中骗
白色之春	白色之春
拍错拖	拍错拖
无人熟识	无人熟识
99次我爱他	99次我爱他
山丹丹花开红艳艳	山丹丹花开红艳艳
寂静的山林	寂静的山林
初代吸血鬼	初代吸血鬼
嘿，老头！	嘿，老头！
保镖	保镖
小爸爸	小爸爸
妈妈	妈妈
秋山澪	秋山澪
the boys	the boys
敌对	敌对
我的帅管家	我的帅管家
漫动作	漫动作
蜕变	蜕变
名人饭堂	名人饭堂
不良主妇	不良主妇
千人迷	千人迷
BRAIN	BRAIN
高考1977	高考1977
熔炉	熔炉
咖喱辣椒	咖喱辣椒
情陷夜中环	情陷夜中环
white	white
一鼓作气	一鼓作气
神枪之出生入死	神枪之出生入死
我不是她	我不是她
尚武精神	尚武精神
英雄无悔	英雄无悔
僵尸之地	僵尸之地
完美的错误	完美的错误
金牌红娘	金牌红娘
我的1919	我的1919
大风车	大风车
真爱如血	真爱如血
寒冬	寒冬
岳母的幸福生活	岳母的幸福生活
走向共和	走向共和
狗与狼的时间	狗与狼的时间
糟糠之妻俱乐部	糟糠之妻俱乐部
五官新说	五官新说
碧血洗银枪	碧血洗银枪
男子汉宣言	男子汉宣言
蓝白红三部曲之蓝	蓝白红三部曲之蓝
飞鹰	飞鹰
绿袖子	绿袖子
想念你的歌	想念你的歌
世间道	世间道
我的黑色小礼服	我的黑色小礼服
热血街头	热血街头
克莱默夫妇	克莱默夫妇
犯贱	犯贱
到爱情为止	到爱情为止
海鸥海鸥	海鸥海鸥
三个摩登女性	三个摩登女性
纪念日	纪念日
当我们同在一起	当我们同在一起
玫瑰玫瑰我爱你	玫瑰玫瑰我爱你
分生	分生
到哪里找那么好的人	到哪里找那么好的人
邻家花美男	邻家花美男
打报告	打报告
再世情缘	再世情缘
冒牌家庭	冒牌家庭
极道君漫游记	极道君漫游记
Friendly Fire	Friendly Fire
脆皮情书	脆皮情书
小螺号	小螺号
过年七天乐	过年七天乐
花葬	花葬
沿海岸线征友	沿海岸线征友
洪武大案	洪武大案
这事儿不赖我	这事儿不赖我
图书馆战争	图书馆战争
青云志	青云志
吸血鬼检察官2	吸血鬼检察官2
庙街十二少	庙街十二少
舌剑上的公堂	舌剑上的公堂
要人警护官	要人警护官
新闺蜜时代	新闺蜜时代
相亲相爱	相亲相爱
死亡笔记	死亡笔记
红线	红线
杨三姐告状	杨三姐告状
少奇同志	少奇同志
郊游	郊游
爱没错	爱没错
巴黎最后的探戈	巴黎最后的探戈
孝子圆梦曲	孝子圆梦曲
迟到	迟到
当男人恋爱时	当男人恋爱时
雁门关	雁门关
明末风云	明末风云
丐侠传奇	丐侠传奇
风雨同路	风雨同路
英宰的全盛时代	英宰的全盛时代
醒你	醒你
娘家	娘家
正午阳光	正午阳光
梦中见	梦中见
水银灯	水银灯
少年进化论	少年进化论
33分侦探	33分侦探
冰河追凶	冰河追凶
万紫千红总是春	万紫千红总是春
延坪海战	延坪海战
无懈可击之美女如云	无懈可击之美女如云
新济公活佛	新济公活佛
真实游戏	真实游戏
射雕英雄传	射雕英雄传
碧玉簪	碧玉簪
你还要我怎样	你还要我怎样
二重心脏	二重心脏
利箭行动	利箭行动
东北抗日联军	东北抗日联军
火火的中国	火火的中国
黑糖秀	黑糖秀
风雪夜归人	风雪夜归人
一诺倾情	一诺倾情
妈妈的庭院	妈妈的庭院
当婆婆遇上妈	当婆婆遇上妈
北风那个吹	北风那个吹
星梦奇缘	星梦奇缘
相爱穿梭千年	相爱穿梭千年
我老婆是大佬	我老婆是大佬
节振国	节振国
蔷薇之恋	蔷薇之恋
朋友样	朋友样
喋血双雄	喋血双雄
我的野蛮女老师2	我的野蛮女老师2
人在旅途	人在旅途
天天有喜2之人间有爱	天天有喜2之人间有爱
铁皮鼓	铁皮鼓
我最摇摆	我最摇摆
颐和园	颐和园
擦皮鞋	擦皮鞋
媳妇的眼泪	媳妇的眼泪
米可，GO!	米可，GO!
板蓝花儿开	板蓝花儿开
嫁衣	嫁衣
大猫儿追爱记	大猫儿追爱记
勇敢的心	勇敢的心
like this	like this
直到主再临为止	直到主再临为止
击浪青春	击浪青春
人尽可夫	人尽可夫
中了爱情毒	中了爱情毒
历史的天空	历史的天空
伤逝	伤逝
秋菊	秋菊
忠诚	忠诚
口碑	口碑
世界大战	世界大战
不夜城	不夜城
红梅白雪贺新春	红梅白雪贺新春
疯狂72小时	疯狂72小时
圣杯神器：骸骨之城	圣杯神器：骸骨之城
爱的故事上集	爱的故事上集
巴黎恋人	巴黎恋人
女驸马	女驸马
摇摆电力公司	摇摆电力公司
喜气洋洋猪八戒	喜气洋洋猪八戒
家族迷情	家族迷情
告别的时代	告别的时代
帅哥医生	帅哥医生
双峰	双峰
关山飞渡	关山飞渡
口袋里的花	口袋里的花
夕岚之街樱之国	夕岚之街樱之国
我的博士老公	我的博士老公
不要恋爱要结婚	不要恋爱要结婚
猩球崛起	猩球崛起
舞吧舞吧在一起	舞吧舞吧在一起
古灵精怪	古灵精怪
变脸	变脸
留白	留白
笑颜的法则	笑颜的法则
缱绻仙凡间	缱绻仙凡间
龙珠传奇之无间道	龙珠传奇之无间道
风尘三侠之红拂女	风尘三侠之红拂女
奥特曼	奥特曼
维奥莱特·诺齐埃尔	维奥莱特·诺齐埃尔
减肥旅行团	减肥旅行团
梅花档案	梅花档案
管不着	管不着
伦敦的爱情	伦敦的爱情
廊桥遗梦	廊桥遗梦
特种兵之火凤凰	特种兵之火凤凰
买佛龛	买佛龛
鹰王	鹰王
我的乖乖女	我的乖乖女
卡里加里博士	卡里加里博士
抱养奇缘	抱养奇缘
荣誉	荣誉
superstar	superstar
雪在烧	雪在烧
义者无敌	义者无敌
爱情对我说了谎	爱情对我说了谎
man in the mirror	man in the mirror
新少林五祖	新少林五祖
小时代之折纸时代	小时代之折纸时代
等你，在雨中	等你，在雨中
宿醉	宿醉
无人区	无人区
迫在眉睫	迫在眉睫
刺客列传	刺客列传
二重心臓	二重心臓
两周	两周
江南	江南
了不起的狐狸爸爸	了不起的狐狸爸爸
血的游戏	血的游戏
女王之花	女王之花
布达佩斯大饭店	布达佩斯大饭店
下女	下女
萧红	萧红
逃跑的木偶	逃跑的木偶
光荣大地	光荣大地
我爱黑涩会	我爱黑涩会
偷妻	偷妻
芳香之旅	芳香之旅
好先生	好先生
沉睡的森林	沉睡的森林
小宝与康熙	小宝与康熙
海扁王	海扁王
因为你	因为你
邮差总按两遍铃	邮差总按两遍铃
林海雪原	林海雪原
只看着我	只看着我
吧嗒吧嗒：他和她心跳的声音	吧嗒吧嗒：他和她心跳的声音
One Fine Day	One Fine Day
波斯王子：时之刃	波斯王子：时之刃
美风蓝	美风蓝
天幕坠落	天幕坠落
波风水门	波风水门
宜昌保卫战	宜昌保卫战
完美丈夫	完美丈夫
怒海雄心	怒海雄心
富贵逼人	富贵逼人
纠纷	纠纷
你不懂我	你不懂我
名濑博臣	名濑博臣
双面佳人	双面佳人
四大须生	四大须生
新熟女时代	新熟女时代
突然想到理想这个词	突然想到理想这个词
丑女无敌	丑女无敌
天桥风云	天桥风云
青铜爱情	青铜爱情
拉蒂兹	拉蒂兹
色·戒	色·戒
Metamorphosis	Metamorphosis
俏女佣	俏女佣
王牌大贱谍	王牌大贱谍
二叔	二叔
千机变	千机变
星光大道	星光大道
韦德	韦德
山城棒棒军	山城棒棒军
面引子	面引子
五根手指	五根手指
独步天下	独步天下
一路繁花相送	一路繁花相送
我的奇妙男友	我的奇妙男友
单数绝配	单数绝配
小洋楼风波	小洋楼风波
战旗	战旗
道熙呀	道熙呀
天堂的宝石	天堂的宝石
原点	原点
越吻越伤心	越吻越伤心
钻石豪门	钻石豪门
那小子真帅	那小子真帅
真命天女	真命天女
家后	家后
新还君明珠	新还君明珠
电竞之王	电竞之王
卧龙吊孝	卧龙吊孝
我的青春谁做主	我的青春谁做主
雪国列车	雪国列车
指尖的温柔	指尖的温柔
爱无赦	爱无赦
魔女的条件	魔女的条件
漂	漂
神探伽利略2	神探伽利略2
门·第	门·第
春日	春日
疯了	疯了
It's raining	It's raining
雨蝶	雨蝶
合伙人	合伙人
春去春又回	春去春又回
再见吧，悲伤	再见吧，悲伤
笨蛋、测验、召唤兽	笨蛋、测验、召唤兽
向阳处的她	向阳处的她
假面骑士OOO	假面骑士OOO
明天的希望	明天的希望
初めてガールズ	初めてガールズ
活佛济公第二部	活佛济公第二部
奥戈	奥戈
Love Warrior战	Love Warrior战
樱野三加一	樱野三加一
故乡	故乡
绅士的品格	绅士的品格
埃博拉病毒	埃博拉病毒
天生缘分归来	天生缘分归来
爱是最大权利	爱是最大权利
心路GPS	心路GPS
金太狼的幸福生活	金太狼的幸福生活
冲天小子	冲天小子
日正当中	日正当中
落跑甜心	落跑甜心
硬汉	硬汉
罗武林向前冲	罗武林向前冲
迈克尔·克莱顿	迈克尔·克莱顿
一贯害人道	一贯害人道
隋唐英雄4	隋唐英雄4
情爱保险	情爱保险
烈火如歌	烈火如歌
加持良治	加持良治
不是因为寂寞才想你	不是因为寂寞才想你
天道霞	天道霞
师兄撞鬼	师兄撞鬼
谢谢你的爱1999	谢谢你的爱1999
落叶归根	落叶归根
花季·雨季	花季·雨季
玫瑰	玫瑰
长辈	长辈
乃梨子海苔便当	乃梨子海苔便当
骄傲	骄傲
亲亲宝贝	亲亲宝贝
白蛇后传	白蛇后传
死之棘	死之棘
今宵重见月团圆	今宵重见月团圆
五福星	五福星
收播新闻	收播新闻
烈火雄心3	烈火雄心3
终极一班3	终极一班3
终极一班2	终极一班2
守望的天空	守望的天空
美丽高解像	美丽高解像
太极旗飘扬	太极旗飘扬
惊异传奇	惊异传奇
独身天下	独身天下
丑女无敌完美季	丑女无敌完美季
暗黑女教师	暗黑女教师
绿巨人浩克	绿巨人浩克
扇子舞	扇子舞
完美妈妈	完美妈妈
爱，一直存在	爱，一直存在
安非他命	安非他命
夏家三千金	夏家三千金
绿光	绿光
坏男人	坏男人
super bass	super bass
Kill Me Heal Me	Kill Me Heal Me
上将洪学智	上将洪学智
影城大亨	影城大亨
心在想念	心在想念
落日谣	落日谣
雨落	雨落
我是不是该安静的走开	我是不是该安静的走开
雪花	雪花
蓝色档案	蓝色档案
砂沙美	砂沙美
清网行动	清网行动
爱过	爱过
仙境之桥	仙境之桥
玉氏南正基	玉氏南正基
最终信仰	最终信仰
左邻右舍	左邻右舍
铁道员	铁道员
万年飘香	万年飘香
海洋天堂	海洋天堂
青春失乐园	青春失乐园
我可以	我可以
拍卖	拍卖
朋友也上床	朋友也上床
旋风管家	旋风管家
高桥启介	高桥启介
美丽的稻穗	美丽的稻穗
乐火男孩	乐火男孩
魔法少女奈叶	魔法少女奈叶
最浪漫的事	最浪漫的事
黑拳	黑拳
法庭内外	法庭内外
梁山伯与茱丽叶	梁山伯与茱丽叶
铁齿铜牙纪晓岚第三部	铁齿铜牙纪晓岚第三部
红箭	红箭
爱丽丝之棘	爱丽丝之棘
阿丽莎	阿丽莎
旋风少女	旋风少女
魔卡少女樱	魔卡少女樱
史上最大作弊战争	史上最大作弊战争
丑八怪	丑八怪
马骝精大闹天宫	马骝精大闹天宫
我的野蛮女友2	我的野蛮女友2
金钱帝国	金钱帝国
阿凡达	阿凡达
遗失的美好	遗失的美好
预约爱情	预约爱情
娱乐插班生	娱乐插班生
你是我的命	你是我的命
高潮艺术	高潮艺术
free!	free!
如果爱可以重来	如果爱可以重来
潮流运动	潮流运动
那就好好过吧	那就好好过吧
战火西北狼	战火西北狼
半边楼	半边楼
残酷天使的行动纲领	残酷天使的行动纲领
爱妻家	爱妻家
黑白照	黑白照
破碎	破碎
二见钟情	二见钟情
城寨出来者	城寨出来者
公园与游憩	公园与游憩
hey girl	hey girl
踏破硝烟	踏破硝烟
王新民	王新民
消失的爱人	消失的爱人
开心魔法	开心魔法
冰与火的青春	冰与火的青春
月光光心慌慌	月光光心慌慌
决战南京	决战南京
古灵精探	古灵精探
碧海追踪	碧海追踪
当四叶草碰上剑尖时	当四叶草碰上剑尖时
一本漫画闯天涯	一本漫画闯天涯
我主皇朝	我主皇朝
危险思想的自白	危险思想的自白
送妆	送妆
王鸣仲	王鸣仲
韩城攻略	韩城攻略
宅门逆子	宅门逆子
鲜花陪伴你	鲜花陪伴你
五鼠斗御猫	五鼠斗御猫
赛德克·巴莱	赛德克·巴莱
和我结婚吧	和我结婚吧
一家老小向前冲	一家老小向前冲
Dream Knight	Dream Knight
刘伯温传奇	刘伯温传奇
忘雪	忘雪
煎饼侠	煎饼侠
哪怕我很小	哪怕我很小
女人最痛	女人最痛
北京女人	北京女人
家常菜	家常菜
锁清秋	锁清秋
大波	大波
大会堂演奏厅	大会堂演奏厅
盗墓风云	盗墓风云
3D豪情	3D豪情
张国荣	张国荣
上海王	上海王
音乐之乡	音乐之乡
墨西哥万岁	墨西哥万岁
冷酷到底	冷酷到底
雾都	雾都
日本	日本
温柔的背后	温柔的背后
黄克功案件	黄克功案件
芙蕾·阿尔斯塔	芙蕾·阿尔斯塔
妻子的诱惑	妻子的诱惑
望	望
还来得及再爱你	还来得及再爱你
花打朝	花打朝
梧桐树	梧桐树
三不管	三不管
维拉·德雷克	维拉·德雷克
007之明日帝国	007之明日帝国
妈妈咪呀！	妈妈咪呀！
异度公寓	异度公寓
赖校生	赖校生
百鸟朝凤	百鸟朝凤
坏孩子的天空	坏孩子的天空
龙猫	龙猫
南春香	南春香
阿娴	阿娴
铁证悬案~真实之门~	铁证悬案~真实之门~
闭嘴家族	闭嘴家族
最天使	最天使
花样江湖	花样江湖
如果蜗牛有爱情	如果蜗牛有爱情
三毛学生意	三毛学生意
小二黑结婚	小二黑结婚
START	START
STARS	STARS
福泽祐巳	福泽祐巳
李春天的春天	李春天的春天
梨花似雪	梨花似雪
蓝猫龙骑团	蓝猫龙骑团
隔窗有眼	隔窗有眼
外事警察	外事警察
双丞戏	双丞戏
和平卫士	和平卫士
中天悬剑	中天悬剑
点子公司	点子公司
Trot恋人	Trot恋人
做你的爱人	做你的爱人
彩色世界	彩色世界
济公外传	济公外传
因为是我的女人	因为是我的女人
流星之绊	流星之绊
再见丽江	再见丽江
综艺黄金档	综艺黄金档
客途秋恨	客途秋恨
赖布衣传奇	赖布衣传奇
李小龙传奇	李小龙传奇
风之画员	风之画员
微笑妈妈	微笑妈妈
Gussanova Ⅱ风带我走吧	Gussanova Ⅱ风带我走吧
九尾狐姐姐传	九尾狐姐姐传
向左走，向右走	向左走，向右走
塔里的女人	塔里的女人
潜伏	潜伏
广播道软硬杀人事件	广播道软硬杀人事件
微笑正义	微笑正义
1986年	1986年
关于莉莉周的一切	关于莉莉周的一切
鹤	鹤
小苹果	小苹果
胭脂雪	胭脂雪
下辈子要嫁给你	下辈子要嫁给你
Lucky Boys	Lucky Boys
我要的不多	我要的不多
我爱你你却爱着他	我爱你你却爱着他
浣花洗剑录	浣花洗剑录
白色恋曲	白色恋曲
来自星星的你	来自星星的你
两忘烟水里	两忘烟水里
百科探秘	百科探秘
小玩意	小玩意
最后一吻	最后一吻
步步惊魂	步步惊魂
巅峰时代	巅峰时代
结婚万岁	结婚万岁
大路朝天	大路朝天
孽吻	孽吻
垂帘听政	垂帘听政
霹雳彩虹	霹雳彩虹
爱上就会死的女人奉顺	爱上就会死的女人奉顺
梦幻佳期	梦幻佳期
花花世界花家姐	花花世界花家姐
时差7小时	时差7小时
忽然之间	忽然之间
锈与骨	锈与骨
Loving you	Loving you
天涯侠医	天涯侠医
心灵捕手	心灵捕手
樱花恋	樱花恋
大话西游3	大话西游3
雷霆玫瑰	雷霆玫瑰
黑暗伊甸园	黑暗伊甸园
我是重庆崽儿	我是重庆崽儿
杨得志围城打援	杨得志围城打援
王朝的女人·杨贵妃	王朝的女人·杨贵妃
护士小葵	护士小葵
红日	红日
问君能有几多愁	问君能有几多愁
Only You	Only You
生死极限	生死极限
独臂刀客	独臂刀客
噬魂师	噬魂师
柳暗花明	柳暗花明
一万个理由	一万个理由
卡嘉莉·尤拉·阿斯哈	卡嘉莉·尤拉·阿斯哈
身为人母	身为人母
别有用心的单身女	别有用心的单身女
学院传说之三生三世桃花缘	学院传说之三生三世桃花缘
乌鸦与麻雀	乌鸦与麻雀
九月鹰飞	九月鹰飞
鬼马狂想曲	鬼马狂想曲
少年去游荡	少年去游荡
阿信	阿信
御坂美琴	御坂美琴
white flag	white flag
万物生长	万物生长
蓝宝石之谜	蓝宝石之谜
巡夜人日志	巡夜人日志
千次的吻	千次的吻
我的见鬼女友	我的见鬼女友
爱闪亮	爱闪亮
熊抱的温柔	熊抱的温柔
怦然心动	怦然心动
国家使命	国家使命
wild	wild
仙侠剑	仙侠剑
灰色控诉	灰色控诉
不见不散	不见不散
青春不败2	青春不败2
我的老千生涯	我的老千生涯
从头再来	从头再来
雪琉璃	雪琉璃
舞者的纯情	舞者的纯情
温柔	温柔
马大帅	马大帅
香草天空	香草天空
女警爱作战	女警爱作战
大头绿衣斗僵尸	大头绿衣斗僵尸
儿行千里	儿行千里
功夫状元	功夫状元
第一神拳	第一神拳
吻瘾者	吻瘾者
明日如歌	明日如歌
超完美夺分	超完美夺分
射星	射星
壮士出川	壮士出川
战神	战神
天下无敌	天下无敌
明天我依然爱你	明天我依然爱你
家有一宝	家有一宝
沙罗双树	沙罗双树
2013我爱HK恭喜发财	2013我爱HK恭喜发财
东方战场	东方战场
烈焰焚情	烈焰焚情
爱是你我	爱是你我
老情人	老情人
傲啸江湖	傲啸江湖
鬼马天师	鬼马天师
岳：冰峰救援	岳：冰峰救援
百年的新娘	百年的新娘
炊事班的故事	炊事班的故事
故都春梦	故都春梦
Lollipop	Lollipop
爱的初告白	爱的初告白
梵谷的左耳	梵谷的左耳
一丝的纯情	一丝的纯情
你的影子	你的影子
进击的巨人 ATTACK ON TITAN	进击的巨人 ATTACK ON TITAN
Gun lae gun	Gun lae gun
僵尸道长	僵尸道长
银色星球	银色星球
当兵干什么	当兵干什么
牧羊曲	牧羊曲
少年魔法师	少年魔法师
双子座	双子座
邦妮·凯瑟琳·赖特	邦妮·凯瑟琳·赖特
又见阿郎	又见阿郎
外婆家	外婆家
被告人	被告人
爱似百汇	爱似百汇
玉女神驹	玉女神驹
唐太宗李世民	唐太宗李世民
不想错过你	不想错过你
女人的秘密	女人的秘密
猫屎妈妈	猫屎妈妈
雏菊	雏菊
普罗米修斯	普罗米修斯
布拉格之恋	布拉格之恋
街角的祝福	街角的祝福
少年张三丰	少年张三丰
沙英	沙英
我的右腿	我的右腿
木更津猫眼	木更津猫眼
终极系列	终极系列
乡村爱情交响曲	乡村爱情交响曲
香港美食100强	香港美食100强
一一向前冲	一一向前冲
永远是春天	永远是春天
860天	860天
盲证	盲证
重返20岁	重返20岁
千禧曼波之蔷薇的名字	千禧曼波之蔷薇的名字
复刻回忆	复刻回忆
一年又一年	一年又一年
无极限	无极限
瑞丽	瑞丽
大清江山之龙胆花	大清江山之龙胆花
萌学园	萌学园
舍不得	舍不得
朱诺	朱诺
感情到老	感情到老
我的主题曲	我的主题曲
离婚前规则	离婚前规则
追月	追月
我的19岁	我的19岁
李家大院	李家大院
不怕不怕	不怕不怕
决定	决定
我不是王毛	我不是王毛
蛋糕上的草莓	蛋糕上的草莓
梦中情人	梦中情人
我要你的爱	我要你的爱
宝马狂想曲	宝马狂想曲
老爸老妈兄弟姐妹	老爸老妈兄弟姐妹
美食侦探	美食侦探
肥猫寻亲记	肥猫寻亲记
一声叹息	一声叹息
美丽的秘密	美丽的秘密
守在转角的希望	守在转角的希望
父与子	父与子
沉睡的青春	沉睡的青春
100次哭泣	100次哭泣
医者仁心	医者仁心
过年	过年
结婚前规则	结婚前规则
小雨中的回忆	小雨中的回忆
斗士	斗士
小商河	小商河
爱德华·艾尔利克	爱德华·艾尔利克
大医院小医师	大医院小医师
嫉妒的深海	嫉妒的深海
乞力马扎罗的雪	乞力马扎罗的雪
恋爱诈欺师	恋爱诈欺师
就想爱着你	就想爱着你
冰川世纪	冰川世纪
曾经太年轻	曾经太年轻
冷面	冷面
八面玲珑的申小姐	八面玲珑的申小姐
玉林的成长日记	玉林的成长日记
再度重相逢	再度重相逢
神兵小将	神兵小将
我的性急男友	我的性急男友
完美小姐进化论	完美小姐进化论
家族的诞生	家族的诞生
红粉世家	红粉世家
播音人	播音人
大明嫔妃	大明嫔妃
胭脂霸王	胭脂霸王
No Mercy	No Mercy
我自己的德意志	我自己的德意志
战魂	战魂
重庆森林	重庆森林
活埋	活埋
热爱	热爱
蜂蜜与四叶草	蜂蜜与四叶草
六尺之下	六尺之下
李隆基	李隆基
懂了	懂了
独裁者	独裁者
我来接您了	我来接您了
家有九凤	家有九凤
南千秋	南千秋
中国远征军	中国远征军
誓约	誓约
关公战秦琼	关公战秦琼
幸福并不遥远	幸福并不遥远
斯蒂尔传奇	斯蒂尔传奇
拥抱明天	拥抱明天
拳霸风云	拳霸风云
纯属意外	纯属意外
恶魔的手球歌	恶魔的手球歌
陀枪师姐	陀枪师姐
看了又看	看了又看
食得峰骚	食得峰骚
新打工谣	新打工谣
谎言西西里	谎言西西里
我们都能幸福着	我们都能幸福着
挑滑车	挑滑车
出门	出门
解学士	解学士
江南传奇之十五贯	江南传奇之十五贯
周刊赤川次郎	周刊赤川次郎
爱情需要奇迹	爱情需要奇迹
恋爱的犀牛	恋爱的犀牛
七龙珠	七龙珠
狼少年	狼少年
冰之恋	冰之恋
单翼天使	单翼天使
敢不敢爱	敢不敢爱
黄河长江	黄河长江
梦想在望	梦想在望
超少年密码	超少年密码
我的丑爹	我的丑爹
垄断者	垄断者
巴特	巴特
海月姬	海月姬
危险年代	危险年代
All I Want For Christmas Is You	All I Want For Christmas Is You
北京北京	北京北京
paradise	paradise
绝对男友	绝对男友
浮华背后	浮华背后
英雄时代	英雄时代
我男人的女人	我男人的女人
无盐女	无盐女
尖锋	尖锋
疯狂天后	疯狂天后
火光	火光
爱之初体验	爱之初体验
Dancing 9	Dancing 9
中国美	中国美
海女	海女
女王的条件	女王的条件
天机算	天机算
三笠·阿克曼	三笠·阿克曼
黄铜茶壶	黄铜茶壶
大营救	大营救
我脚下之路	我脚下之路
智取威虎山3D	智取威虎山3D
星矢	星矢
无敌铁桥三	无敌铁桥三
到也门钓鲑鱼	到也门钓鲑鱼
第二次人生	第二次人生
一双旧皮鞋	一双旧皮鞋
一曲情歌三代缘	一曲情歌三代缘
蜘蛛侠2	蜘蛛侠2
猛龙过江	猛龙过江
can you feel the love tonight	can you feel the love tonight
真爱趁现在	真爱趁现在
感谢亲人	感谢亲人
情战	情战
70年代时尚精英	70年代时尚精英
王元口力口	王元口力口
宝岛少女成功记	宝岛少女成功记
少年天子	少年天子
存在	存在
给我乖	给我乖
我的翅膀	我的翅膀
哥斯拉X摩斯拉X机械哥斯拉：东京SOS	哥斯拉X摩斯拉X机械哥斯拉：东京SOS
如果没有明天	如果没有明天
伤城之恋	伤城之恋
向日葵的承诺	向日葵的承诺
李二嫂改嫁	李二嫂改嫁
mama	mama
八女投江	八女投江
妻之告白	妻之告白
飞虎	飞虎
美味关系	美味关系
珍珠耳环	珍珠耳环
神探	神探
i could be the one	i could be the one
reflection	reflection
海螺小姐	海螺小姐
双海亚美	双海亚美
sou love baby	sou love baby
Look At Me Now	Look At Me Now
苏州	苏州
乡村爱情	乡村爱情
约翰	约翰
康熙微服私访记	康熙微服私访记
一生中最爱	一生中最爱
蚂蚁	蚂蚁
数学女子学园	数学女子学园
野猪大改造	野猪大改造
浪客剑心	浪客剑心
幸福选择题	幸福选择题
爱情36计	爱情36计
悲惨世界	悲惨世界
豆丁奇遇记	豆丁奇遇记
天边花正香	天边花正香
彩蝶	彩蝶
Pierrot	Pierrot
真月谭月姬	真月谭月姬
夜班经理	夜班经理
爱也好恨也好	爱也好恨也好
东风	东风
童年	童年
萌学园5：异界对决	萌学园5：异界对决
拿什么拯救你，我的爱人	拿什么拯救你，我的爱人
草莓之夜	草莓之夜
一场风花雪月的事	一场风花雪月的事
第一天	第一天
Until you	Until you
情报	情报
变身男女	变身男女
海上孟府	海上孟府
忘掉我是谁	忘掉我是谁
秋霞	秋霞
why not	why not
秋霜	秋霜
我的早更女友	我的早更女友
关键时刻	关键时刻
你看你看月亮的脸	你看你看月亮的脸
黑崎一护	黑崎一护
碧血青天杨家将	碧血青天杨家将
解放	解放
Rh阳性	Rh阳性
婚姻保卫战	婚姻保卫战
我们一家都是人	我们一家都是人
心星的泪光	心星的泪光
整形外科	整形外科
千岁情人	千岁情人
想你的时候	想你的时候
红罂粟	红罂粟
狮子山下	狮子山下
ONE OF A KIND	ONE OF A KIND
我爱我家	我爱我家
女孩儿与四重奏	女孩儿与四重奏
当狗爱上猫	当狗爱上猫
男人不醉	男人不醉
普通朋友	普通朋友
29岁的圣诞节	29岁的圣诞节
清朝Party	清朝Party
奸细	奸细
楢山节考	楢山节考
那个傻瓜	那个傻瓜
JL	JL
夜幕降临前	夜幕降临前
笑笑离开	笑笑离开
全民目击	全民目击
聊聊	聊聊
带我走	带我走
掩护	掩护
秘密男女	秘密男女
海底总动员	海底总动员
贞观长歌	贞观长歌
郎心如铁	郎心如铁
乌龙山剿匪记	乌龙山剿匪记
过客	过客
屌丝的寂寞	屌丝的寂寞
我不会唱歌	我不会唱歌
第三只眼	第三只眼
情敌	情敌
使徒行者	使徒行者
仰望星空	仰望星空
invoke	invoke
地下裁决	地下裁决
非常公寓	非常公寓
友情岁月	友情岁月
The note of my twenty years	The note of my twenty years
楚留香之蝙蝠传奇	楚留香之蝙蝠传奇
鸢之恋	鸢之恋
说不哭	说不哭
花水木	花水木
正阳门下	正阳门下
只有神知道的世界	只有神知道的世界
May Queen	May Queen
月落泉	月落泉
熊猫人	熊猫人
方伯谦	方伯谦
时时刻刻	时时刻刻
timeless	timeless
我家的恶魔与天使	我家的恶魔与天使
All about You	All about You
proud of you	proud of you
一无所有	一无所有
人间第一情	人间第一情
我的美丽人生	我的美丽人生
武装	武装
不客气三部曲	不客气三部曲
时尚	时尚
无耻混蛋	无耻混蛋
突出重围	突出重围
我的完美男人	我的完美男人
哈利·波特与密室	哈利·波特与密室
菊花醉	菊花醉
V.V.I.P	V.V.I.P
故土	故土
数码宝贝	数码宝贝
坝上街	坝上街
风水世家	风水世家
娘	娘
生于七月四日	生于七月四日
爱有来生	爱有来生
希望之光	希望之光
其实我还好	其实我还好
纸醉金迷	纸醉金迷
鸡排英雄	鸡排英雄
女子监狱	女子监狱
斥候之剑	斥候之剑
有一天我会	有一天我会
鹰隼大队	鹰隼大队
建军大业	建军大业
solo	solo
爱的成人式	爱的成人式
父子雄兵	父子雄兵
幸福小镇之浪漫满屋	幸福小镇之浪漫满屋
生死英雄	生死英雄
卓依婷依然记得演艺30周年巡回演唱会	卓依婷依然记得演艺30周年巡回演唱会
洛神	洛神
Janus	Janus
绝对权力	绝对权力
香草恋人馆	香草恋人馆
再向虎山行	再向虎山行
插树岭	插树岭
黄昏清兵卫	黄昏清兵卫
吉祥天宝	吉祥天宝
楼兰幽灵	楼兰幽灵
Rainy Blue	Rainy Blue
陆小凤传奇之大金鹏王	陆小凤传奇之大金鹏王
伊莉雅斯菲尔·冯·爱因兹贝伦	伊莉雅斯菲尔·冯·爱因兹贝伦
赴宴	赴宴
这个世界会好吗	这个世界会好吗
叮咚	叮咚
百折不挠具海拉	百折不挠具海拉
只是你不在	只是你不在
跑跑跑	跑跑跑
乡野人	乡野人
我不是曾轶可	我不是曾轶可
好歌献给你	好歌献给你
活佛济公	活佛济公
食为奴	食为奴
智者无敌	智者无敌
花非花雾非雾	花非花雾非雾
菊丸英二	菊丸英二
女人的香气	女人的香气
信长的主厨	信长的主厨
铁甲小宝	铁甲小宝
大唐女巡按	大唐女巡按
可疑的三兄弟	可疑的三兄弟
后来的我们	后来的我们
新警察故事	新警察故事
梅花三弄	梅花三弄
都是你	都是你
公众之敌	公众之敌
街亭之战	街亭之战
分手达人	分手达人
扎职	扎职
同一首歌	同一首歌
港囧	港囧
怒火街头2	怒火街头2
16个夏天	16个夏天
女高中生结婚记	女高中生结婚记
四大天王	四大天王
找一个字代替	找一个字代替
金钱游戏	金钱游戏
恋爱革命	恋爱革命
刁蛮新娘	刁蛮新娘
不想让你知道	不想让你知道
法网群英	法网群英
倾国倾城	倾国倾城
空房间	空房间
京港爱情线	京港爱情线
锦绣良缘	锦绣良缘
I Need A GIRL	I Need A GIRL
鱼缸	鱼缸
光与影	光与影
玫瑰绽放的年代	玫瑰绽放的年代
钢琴女生	钢琴女生
保护证人组	保护证人组
我回来了	我回来了
醉乡民谣	醉乡民谣
新扎师妹3	新扎师妹3
辛亥革命	辛亥革命
闪婚	闪婚
东京DOGS	东京DOGS
冥王星	冥王星
唐突的女子	唐突的女子
陀螺	陀螺
全民公主	全民公主
西干道	西干道
最后一击	最后一击
十七岁不哭	十七岁不哭
莽荒纪	莽荒纪
吸血鬼	吸血鬼
后宫：帝王之妾	后宫：帝王之妾
钢琴课	钢琴课
穿越时空的爱恋	穿越时空的爱恋
曾经与你有个梦	曾经与你有个梦
扫黄先锋	扫黄先锋
灰色河堤	灰色河堤
没有男人也能好好的	没有男人也能好好的
星球大战	星球大战
you don't miss your water	you don't miss your water
潮起潮落	潮起潮落
西游记续集	西游记续集
火箭男孩	火箭男孩
奔跑吧兄弟	奔跑吧兄弟
开心公寓	开心公寓
站台	站台
魔宫魅影	魔宫魅影
闯天涯	闯天涯
平凡之路	平凡之路
寂寞才说爱	寂寞才说爱
草原夜色美	草原夜色美
孤岛秘密战	孤岛秘密战
人生旅程	人生旅程
纯情闪耀	纯情闪耀
廉政英雄	廉政英雄
那口锅	那口锅
金鹰网	金鹰网
猛鬼爱情故事	猛鬼爱情故事
长坂坡	长坂坡
梅花香	梅花香
忍不住原谅	忍不住原谅
非常接触	非常接触
no promises	no promises
惊恐症	惊恐症
约翰·塞巴斯蒂安·巴赫	约翰·塞巴斯蒂安·巴赫
再次，秋来	再次，秋来
瞬	瞬
女娲传说之灵珠	女娲传说之灵珠
让我听懂你的语言	让我听懂你的语言
慎点第二季	慎点第二季
半边灵	半边灵
沧海横流	沧海横流
唐吉诃德·多弗朗明哥	唐吉诃德·多弗朗明哥
吉祥天女	吉祥天女
沉默的瞬间	沉默的瞬间
东京攻略	东京攻略
绝杀	绝杀
唱片	唱片
人妻	人妻
今日升堂	今日升堂
专家指导	专家指导
初告白	初告白
发条城市	发条城市
武松打虎	武松打虎
公主的迷信	公主的迷信
原来爱上贼	原来爱上贼
古惑仔之人在江湖	古惑仔之人在江湖
寿堂	寿堂
给我一个吻	给我一个吻
古惑仔	古惑仔
青河绝唱	青河绝唱
赵氏孤儿案	赵氏孤儿案
最亲爱的你	最亲爱的你
恩田赤	恩田赤
人生没有如果	人生没有如果
我想去桂林	我想去桂林
让我爱着你	让我爱着你
回到最初	回到最初
归亚蕾	归亚蕾
太天真	太天真
甲你揽牢牢	甲你揽牢牢
恋爱世纪	恋爱世纪
I will always love you	I will always love you
bad romance	bad romance
新天生一对	新天生一对
出包王女	出包王女
电视剧	电视剧
美丽家庭	美丽家庭
台湾首任巡抚刘铭传	台湾首任巡抚刘铭传
一日夫妻百日恩	一日夫妻百日恩
结城梨斗	结城梨斗
千分之一	千分之一
认识你真好	认识你真好
潘金莲	潘金莲
王昭君	王昭君
娜娜莉·V·布里塔尼亚	娜娜莉·V·布里塔尼亚
小世界	小世界
江湖再见	江湖再见
梵·高传	梵·高传
千金女贼	千金女贼
爱无限	爱无限
紫金锤	紫金锤
小狐狸	小狐狸
雾里看花	雾里看花
园崎魉	园崎魉
思念是一种病	思念是一种病
真正的男人	真正的男人
情非得已	情非得已
寻找周杰伦	寻找周杰伦
The Way We Were	The Way We Were
黄绮珊	黄绮珊
陆小凤	陆小凤
女儿情	女儿情
坏小子	坏小子
从将军到士兵	从将军到士兵
Xman	Xman
前方后方	前方后方
高长恭	高长恭
等	等
45周年	45周年
橄榄树	橄榄树
我为你狂	我为你狂
成为朱莉娅	成为朱莉娅
世间路	世间路
当你孤单你会想起谁	当你孤单你会想起谁
杂技	杂技
中国刑警803	中国刑警803
机器人之恋	机器人之恋
爱情是什么	爱情是什么
Without Me	Without Me
悲伤电影	悲伤电影
挪威的森林	挪威的森林
挺住！李波罗	挺住！李波罗
小姨多鹤	小姨多鹤
人生超幽默	人生超幽默
大逃杀	大逃杀
空虚，沸腾	空虚，沸腾
Bad Girl Good Girl	Bad Girl Good Girl
小祖宗	小祖宗
永不消逝的电波	永不消逝的电波
猎杀	猎杀
移情别恋	移情别恋
地球两边	地球两边
宝贝计划	宝贝计划
天蓝蓝	天蓝蓝
料理新鲜人	料理新鲜人
聊斋之花姑子	聊斋之花姑子
杉杉来了	杉杉来了
人活一张脸	人活一张脸
星星月亮太阳	星星月亮太阳
花样姐姐第二季	花样姐姐第二季
家产	家产
晴天雨天	晴天雨天
卡门	卡门
四度空间	四度空间
不要在我寂寞的时候说爱我	不要在我寂寞的时候说爱我
富贵门	富贵门
大赌场	大赌场
太阳的新娘	太阳的新娘
鬼子来了	鬼子来了
斯巴达300勇士	斯巴达300勇士
伊甸园之东	伊甸园之东
传说系列	传说系列
如果和你相爱	如果和你相爱
怎么说我不爱你	怎么说我不爱你
探花道士	探花道士
阿郎	阿郎
马大姐	马大姐
黄金大劫案	黄金大劫案
女皇令	女皇令
卿本佳人	卿本佳人
海峡	海峡
刀尖上行走	刀尖上行走
基督山伯爵	基督山伯爵
包公案	包公案
飞龙在天	飞龙在天
奇怪的她	奇怪的她
爱自由	爱自由
失落沙洲	失落沙洲
最完美的人生终点	最完美的人生终点
到炮火中去	到炮火中去
家仇	家仇
胭脂水粉	胭脂水粉
只是人生	只是人生
PMAM	PMAM
谍海风云	谍海风云
瑰宝1949	瑰宝1949
快乐大本营之快乐到家	快乐大本营之快乐到家
全金属裂痕	全金属裂痕
伪装者	伪装者
李儒	李儒
Big up	Big up
少女小渔	少女小渔
精武门	精武门
放开我北鼻	放开我北鼻
灰眼珠的男孩	灰眼珠的男孩
山风一样自由	山风一样自由
丐中丐	丐中丐
大人物	大人物
光复节特赦	光复节特赦
那么厉害	那么厉害
喜帖街	喜帖街
我想我不够好	我想我不够好
寻梦	寻梦
仁医2	仁医2
好好过	好好过
超人马大姐	超人马大姐
观相	观相
医道	医道
你潇洒我漂亮	你潇洒我漂亮
美丽心灵	美丽心灵
长大后我就成了你	长大后我就成了你
阿浅来了	阿浅来了
家有囍事	家有囍事
盗墓女	盗墓女
逝去的爱	逝去的爱
拜见希特勒	拜见希特勒
船	船
七月俏佳人	七月俏佳人
花有重开日	花有重开日
西北偏北	西北偏北
家乡	家乡
我在黑社会的日子	我在黑社会的日子
赵氏孤儿	赵氏孤儿
49日	49日
关东大先生	关东大先生
龙争虎斗	龙争虎斗
大内密探零零狗	大内密探零零狗
乔家大院	乔家大院
独角戏	独角戏
学园默示录	学园默示录
寻找梦幻岛	寻找梦幻岛
猎鹰1949	猎鹰1949
暖情	暖情
不一样的美男子	不一样的美男子
天国禁书	天国禁书
加油！好男儿	加油！好男儿
月之恋人	月之恋人
挑战	挑战
我的男神	我的男神
山丘之王	山丘之王
怪谈	怪谈
无法说爱你	无法说爱你
狼的诱惑	狼的诱惑
大秦帝国之崛起	大秦帝国之崛起
东京超恐怖传说	东京超恐怖传说
来去夏威夷	来去夏威夷
千金保姆	千金保姆
花子与安妮	花子与安妮
请回答1997	请回答1997
900重案追凶	900重案追凶
梁山伯与祝英台	梁山伯与祝英台
请回答1994	请回答1994
黄鹤楼	黄鹤楼
花儿为什么这样红	花儿为什么这样红
诛仙	诛仙
陆贞传奇	陆贞传奇
在水一方	在水一方
镭射青春	镭射青春
Just Listen	Just Listen
重庆谍战	重庆谍战
枪火	枪火
练舞功	练舞功
英雄郑成功	英雄郑成功
别等我离开才说爱我	别等我离开才说爱我
少年宝亲王	少年宝亲王
forever 21	forever 21
毛利小五郎	毛利小五郎
实习医生格蕾	实习医生格蕾
公主复仇记	公主复仇记
错爱	错爱
河东狮吼Ⅱ	河东狮吼Ⅱ
全开女孩	全开女孩
最火搭档2	最火搭档2
五月花开	五月花开
98古惑仔之龙争虎斗	98古惑仔之龙争虎斗
至尊红颜	至尊红颜
死神的精度	死神的精度
柜中美人	柜中美人
薰衣草	薰衣草
毕业那年	毕业那年
地球勇士	地球勇士
相亲	相亲
月亮怎能代表我的心	月亮怎能代表我的心
中华好诗词	中华好诗词
再一次happy ending	再一次happy ending
医龙	医龙
祝福你	祝福你
羽川翼	羽川翼
与往事干杯	与往事干杯
风流种子	风流种子
职场恋爱史	职场恋爱史
暮光之城：月食	暮光之城：月食
左轮手枪	左轮手枪
幸福的味道	幸福的味道
溏心风暴之家好月圆	溏心风暴之家好月圆
电话谋杀案	电话谋杀案
家在远方	家在远方
别告诉爸爸	别告诉爸爸
我的爱对你说	我的爱对你说
SARA	SARA
这样的女人	这样的女人
江南四大才子	江南四大才子
最后的朋友	最后的朋友
高校处世王	高校处世王
单身贵族	单身贵族
我要复仇	我要复仇
九二神雕侠侣之痴心情长剑	九二神雕侠侣之痴心情长剑
突围行动	突围行动
春江花月夜	春江花月夜
西索	西索
牧场之家好作伴	牧场之家好作伴
一粒红尘	一粒红尘
皇嫂田桂花	皇嫂田桂花
医家兄弟	医家兄弟
公公出宫	公公出宫
将军号	将军号
黄真伊	黄真伊
乔治亚法则	乔治亚法则
倍儿爽	倍儿爽
爱情码头	爱情码头
桥上的女孩	桥上的女孩
原来你什么都不想要	原来你什么都不想要
绯闻女友	绯闻女友
真宫寺樱	真宫寺樱
桃花扇喋血记	桃花扇喋血记
Kiss×sis 亲亲姐姐	Kiss×sis 亲亲姐姐
半份关心	半份关心
碧血剑	碧血剑
同门	同门
我会好好过	我会好好过
HELLO梁心颐	HELLO梁心颐
婚礼2008	婚礼2008
面具	面具
玛尼情歌	玛尼情歌
肖申克的救赎	肖申克的救赎
吻别	吻别
sexy	sexy
远坂凛	远坂凛
最后的抱怨	最后的抱怨
鹿回头	鹿回头
我是真的	我是真的
是非题	是非题
最熟悉的陌生人	最熟悉的陌生人
谁动了我的琴弦	谁动了我的琴弦
醉后决定爱上你	醉后决定爱上你
再见艳阳天	再见艳阳天
一生不变	一生不变
今夜你会不会来	今夜你会不会来
叶问前传	叶问前传
早安少女组	早安少女组
人生的车站	人生的车站
国际大营救	国际大营救
风中劲草	风中劲草
只因单身在一起	只因单身在一起
梦游计	梦游计
万水千山纵横	万水千山纵横
济公传奇	济公传奇
美国往事	美国往事
惊世媳妇	惊世媳妇
黛玉传	黛玉传
魂之轮回	魂之轮回
相信	相信
包青天之开封奇案	包青天之开封奇案
皮五传奇	皮五传奇
保持通话	保持通话
聚散两依依	聚散两依依
铁狮玉玲珑	铁狮玉玲珑
闭嘴！花美男乐队	闭嘴！花美男乐队
两个月亮	两个月亮
狐狸精	狐狸精
不够勇敢	不够勇敢
想唱就唱	想唱就唱
警探雷鸣	警探雷鸣
恋之风景	恋之风景
勇士的奇遇	勇士的奇遇
汇通天下	汇通天下
热天午后	热天午后
圣城记	圣城记
黑狐	黑狐
自恋刑警	自恋刑警
穆桂英	穆桂英
恋恋风尘	恋恋风尘
局中局	局中局
10个约定	10个约定
我是路人甲	我是路人甲
咱们相爱吧	咱们相爱吧
商之痕	商之痕
万水千山风雨情	万水千山风雨情
噗通噗通的良心	噗通噗通的良心
特种兵之霹雳火	特种兵之霹雳火
大地飞歌	大地飞歌
小娘惹	小娘惹
别对我说谎	别对我说谎
乞丐皇帝传奇	乞丐皇帝传奇
利剑	利剑
我用自己的方式爱你	我用自己的方式爱你
她很漂亮	她很漂亮
涅吉·史普林菲尔德	涅吉·史普林菲尔德
九号女神	九号女神
无人生还	无人生还
光明的未来	光明的未来
愤怒的小孩	愤怒的小孩
缘来幸福	缘来幸福
星际牛仔	星际牛仔
情定三生	情定三生
11分钟	11分钟
樱桃女声	樱桃女声
养母	养母
回声嘹亮	回声嘹亮
Breathless	Breathless
石破天惊	石破天惊
rude boy	rude boy
新火烧红莲寺	新火烧红莲寺
次郎长三国志	次郎长三国志
棋王和他的儿子	棋王和他的儿子
惠化，洞	惠化，洞
好久不见	好久不见
指匠情挑	指匠情挑
知己	知己
暗香	暗香
卓玛	卓玛
老莫的第二个春天	老莫的第二个春天
战金岭	战金岭
冲绳之风	冲绳之风
对不起我爱你	对不起我爱你
血疑	血疑
哑女告状	哑女告状
十二月的奇迹	十二月的奇迹
在水中央	在水中央
精忠报国	精忠报国
Wild Soul	Wild Soul
不一样的美男子Ⅱ	不一样的美男子Ⅱ
四月之吻	四月之吻
绝对零度2	绝对零度2
清明上河图	清明上河图
妻子的秘密	妻子的秘密
怪奇大作战	怪奇大作战
雌雄大盗	雌雄大盗
考试之神	考试之神
雨过天晴	雨过天晴
杀虎口	杀虎口
重案六组第二部	重案六组第二部
有爱就有阳光	有爱就有阳光
旧情照相馆	旧情照相馆
东边西边	东边西边
红河	红河
有完没完	有完没完
没有眼泪的鱼	没有眼泪的鱼
匆匆	匆匆
非常宅	非常宅
烽火芳菲	烽火芳菲
蒋筑英	蒋筑英
蝎子王	蝎子王
五女拜寿	五女拜寿
陪你到天涯	陪你到天涯
如同悲伤被下载了两次	如同悲伤被下载了两次
蚁人	蚁人
无尽旋转	无尽旋转
南越王	南越王
天将雄师	天将雄师
特别	特别
龙咁威2	龙咁威2
可疑的保姆	可疑的保姆
推拿	推拿
赤目四十八瀑布殉情未遂	赤目四十八瀑布殉情未遂
dearest	dearest
鬼吹灯之牧野诡事	鬼吹灯之牧野诡事
亲爱的偏执狂	亲爱的偏执狂
我的唐朝兄弟	我的唐朝兄弟
我爱芳邻	我爱芳邻
值得	值得
心动	心动
特搜战队刑事连者	特搜战队刑事连者
剑煮红颜	剑煮红颜
一九四二	一九四二
初吻	初吻
再见先生	再见先生
寂寞空庭春欲晚	寂寞空庭春欲晚
不屑	不屑
孔雀	孔雀
大城小事	大城小事
摇篮曲	摇篮曲
情歌	情歌
发生秀	发生秀
没那么简单	没那么简单
德里克·罗斯	德里克·罗斯
月光皇冠	月光皇冠
台湾1895	台湾1895
我人生的春天	我人生的春天
情人知己	情人知己
come to me	come to me
何必有我	何必有我
玫瑰花	玫瑰花
汉尼拔	汉尼拔
鹿鼎记	鹿鼎记
白狐	白狐
大西洋城	大西洋城
领悟	领悟
最后的爱，最初的爱	最后的爱，最初的爱
流泪	流泪
新上海滩	新上海滩
打抱不平	打抱不平
曼福特医生	曼福特医生
女高怪谈2：交换日记	女高怪谈2：交换日记
金发缪斯	金发缪斯
My Life	My Life
东南西北风	东南西北风
铁道游击队2	铁道游击队2
江北好人	江北好人
梦想一起来	梦想一起来
电视风云	电视风云
金田一一	金田一一
爱极限	爱极限
人工智能	人工智能
狐仙	狐仙
仁心解码	仁心解码
关中匪事	关中匪事
男人真辛苦	男人真辛苦
老朋友，你是否记得	老朋友，你是否记得
战狼	战狼
江南1970	江南1970
姐姐词典	姐姐词典
机动武斗传G高达	机动武斗传G高达
亲爱的，我爱上别人了	亲爱的，我爱上别人了
第八警区	第八警区
原来爱情那么难	原来爱情那么难
中国机长	中国机长
出水芙蓉	出水芙蓉
铁血红安	铁血红安
嫁给他就忘了我	嫁给他就忘了我
黑天鹅事件	黑天鹅事件
黄炎培	黄炎培
水晶之恋	水晶之恋
Love Me Better	Love Me Better
爱情魔戒	爱情魔戒
BEST FICTION	BEST FICTION
裙角飞扬	裙角飞扬
薯童谣	薯童谣
老公老公我爱你	老公老公我爱你
100种生活	100种生活
灰姑娘的姐姐	灰姑娘的姐姐
缘来是你	缘来是你
风林火山	风林火山
虎王	虎王
SOS请救救我	SOS请救救我
Doctor-X~外科医·大门未知子~	Doctor-X~外科医·大门未知子~
和平的代价	和平的代价
雪地里的星星	雪地里的星星
罗密欧与茱丽叶	罗密欧与茱丽叶
最后的王爷	最后的王爷
双城计中计	双城计中计
哆啦A梦	哆啦A梦
四驱兄弟	四驱兄弟
钟鼓楼	钟鼓楼
楚汉风云	楚汉风云
济众院	济众院
非诚勿扰	非诚勿扰
西部放歌	西部放歌
温水	温水
薛仁贵传奇	薛仁贵传奇
外乡人	外乡人
1982年	1982年
涅茧利	涅茧利
幸福的青鸟	幸福的青鸟
喜欢一个人	喜欢一个人
藤乃静留	藤乃静留
No Bravery	No Bravery
康熙王朝	康熙王朝
灰姑娘与四骑士	灰姑娘与四骑士
克拉恋人	克拉恋人
士兵突击	士兵突击
当男人变成女人	当男人变成女人
窃听风云	窃听风云
感情生活	感情生活
国王的演讲	国王的演讲
指环王：双塔奇兵	指环王：双塔奇兵
那年青春我们正好	那年青春我们正好
书圣王羲之	书圣王羲之
等不到的爱	等不到的爱
神话	神话
阿旺新传	阿旺新传
一周年	一周年
overture	overture
月光爱人	月光爱人
为奴十二年	为奴十二年
星光传奇	星光传奇
无颜美女	无颜美女
在世界中心呼唤爱	在世界中心呼唤爱
大舌头	大舌头
画皮	画皮
中国城	中国城
薄荷糖	薄荷糖
281封信	281封信
九妹	九妹
秘杀名单	秘杀名单
it girl	it girl
丑女无敌3	丑女无敌3
汪洋中的一条船	汪洋中的一条船
木乃伊	木乃伊
镖行天下	镖行天下
新九品芝麻官	新九品芝麻官
蜘蛛侠：归来	蜘蛛侠：归来
斗牌传说	斗牌传说
圣女贞德	圣女贞德
警察有约	警察有约
芒果之歌	芒果之歌
等待幸福	等待幸福
our time	our time
爱情不是一切	爱情不是一切
紧急迫降	紧急迫降
桌球天王	桌球天王
中国地	中国地
元卓的天使	元卓的天使
惩罚者	惩罚者
垂涎之岛	垂涎之岛
雨花石	雨花石
红白红白我胜利	红白红白我胜利
驯悍记	驯悍记
为了N	为了N
给你生命给我爱	给你生命给我爱
共助	共助
Perfect Sense	Perfect Sense
洪洞大槐树寻根祭祖园旅游景区	洪洞大槐树寻根祭祖园旅游景区
青色火焰	青色火焰
孤独	孤独
星光下的思念	星光下的思念
Locked Out Of Heaven	Locked Out Of Heaven
我全都相信	我全都相信
另一个哥哥	另一个哥哥
红犬历险记	红犬历险记
至尊无赖	至尊无赖
芳龄十三	芳龄十三
why	why
翻糖花园	翻糖花园
结婚	结婚
如果还有明天	如果还有明天
单刀会	单刀会
山林中头一个女人	山林中头一个女人
石动乃绘	石动乃绘
为你自豪	为你自豪
帽子工厂	帽子工厂
亚洲第一女声	亚洲第一女声
情歌两三首	情歌两三首
藏龙卧虎	藏龙卧虎
青蜂侠	青蜂侠
东方之珠	东方之珠
钱姓	钱姓
岁岁清明	岁岁清明
铠甲勇士刑天	铠甲勇士刑天
民谣搜集者	民谣搜集者
醉	醉
你是最好的自己	你是最好的自己
只爱陌生人	只爱陌生人
家有儿女	家有儿女
一路顺疯	一路顺疯
歌手	歌手
雪域昆仑	雪域昆仑
饥饿游戏2：星火燎原	饥饿游戏2：星火燎原
夜色行动	夜色行动
黄金地带	黄金地带
心咒	心咒
犀利人妻最终回：幸福男·不难	犀利人妻最终回：幸福男·不难
太过爱你	太过爱你
向着太阳歌唱	向着太阳歌唱
紫日	紫日
与光同行	与光同行
赌侠Ⅱ之上海滩赌圣	赌侠Ⅱ之上海滩赌圣
千王之王2000	千王之王2000
男人为什么累	男人为什么累
警徽天职2	警徽天职2
魔剑侠情	魔剑侠情
欧若拉	欧若拉
浪漫樱花	浪漫樱花
跨界歌王	跨界歌王
浮沉	浮沉
笼困	笼困
屋顶上的绿宝石	屋顶上的绿宝石
小气大财神	小气大财神
异形大战铁血战士2	异形大战铁血战士2
断掌顺娘	断掌顺娘
咱们结婚吧	咱们结婚吧
北平无战事	北平无战事
X战警	X战警
艺人	艺人
爱上查美乐	爱上查美乐
美丽晨曦	美丽晨曦
Love, Day After Tomorrow	Love, Day After Tomorrow
盛宴	盛宴
千网危情	千网危情
时代序曲	时代序曲
Home Sweet Home	Home Sweet Home
坏天使	坏天使
白昼之月	白昼之月
女人如花	女人如花
星马豪	星马豪
法外情	法外情
敌特在行动	敌特在行动
月圆今宵	月圆今宵
不良家族	不良家族
宝贝	宝贝
怒放	怒放
包青天之碧血丹心	包青天之碧血丹心
小鬼当家	小鬼当家
芈月传	芈月传
水浒英雄传	水浒英雄传
麻辣变形计	麻辣变形计
雪花那个飘	雪花那个飘
狂风里拥抱	狂风里拥抱
杜拉拉之似水年华	杜拉拉之似水年华
银狼怪奇事件簿	银狼怪奇事件簿
观音山	观音山
birds	birds
明成皇后	明成皇后
烟田少年	烟田少年
毕业生	毕业生
决战玄武门	决战玄武门
八仙饭店之人肉叉烧包	八仙饭店之人肉叉烧包
老表，你好嘢！	老表，你好嘢！
joy	joy
大宋提刑官	大宋提刑官
好彩撞到你	好彩撞到你
小神的儿女	小神的儿女
武则天秘史	武则天秘史
西洋古董洋果子店	西洋古董洋果子店
室友	室友
青春时光	青春时光
沙桥饯别	沙桥饯别
东方Project	东方Project
命中雷霆	命中雷霆
羊肉泡馍麻辣烫	羊肉泡馍麻辣烫
其实一个人过也很好	其实一个人过也很好
我是NO.1	我是NO.1
火影	火影
不浪漫的浪漫	不浪漫的浪漫
洗冤录	洗冤录
我终于失去了你	我终于失去了你
混在北京	混在北京
如果这就是爱情	如果这就是爱情
亚瑟王	亚瑟王
SUNNY DAY	SUNNY DAY
完全没问题	完全没问题
秀逗魔导士	秀逗魔导士
行行出状元	行行出状元
战争不相信眼泪	战争不相信眼泪
精舞门	精舞门
如懿传	如懿传
大唐游侠传	大唐游侠传
爱情歌	爱情歌
人在囧途	人在囧途
西征梦	西征梦
爱情是从告白开始的	爱情是从告白开始的
满江红	满江红
迷失	迷失
还珠格格第三部	还珠格格第三部
老爸驾到	老爸驾到
都市笑口组	都市笑口组
红粉	红粉
公主候补生佑希	公主候补生佑希
缠绵游戏	缠绵游戏
爱疯了	爱疯了
白水滩	白水滩
卡拉是条狗	卡拉是条狗
不知道方向	不知道方向
来自天上的声音	来自天上的声音
新步步惊心	新步步惊心
冰山上的来客	冰山上的来客
爱一万次够不够	爱一万次够不够
苦凤莺怜	苦凤莺怜
春生	春生
秋香	秋香
长在面包树上的女人	长在面包树上的女人
火山高校	火山高校
四大名捕3	四大名捕3
四大名捕2	四大名捕2
肝胆相照	肝胆相照
30个门钥匙	30个门钥匙
悠长假期	悠长假期
为你疯狂	为你疯狂
寻找	寻找
笨小孩	笨小孩
青谷子	青谷子
大道通天	大道通天
8090向前冲	8090向前冲
象人	象人
谋杀似水年华	谋杀似水年华
向着胜利前进	向着胜利前进
MIM-104防空导弹	MIM-104防空导弹
生死搏斗	生死搏斗
谈情说案	谈情说案
杜拉拉升职记	杜拉拉升职记
美丽的草原我的家	美丽的草原我的家
千反田爱瑠	千反田爱瑠
蝙蝠侠黑暗骑士三部曲	蝙蝠侠黑暗骑士三部曲
也可以	也可以
名侦探柯南电视剧特别篇：工藤新一京都新撰组杀人事件	名侦探柯南电视剧特别篇：工藤新一京都新撰组杀人事件
五官争功	五官争功
台北神话	台北神话
我们的存在	我们的存在
了不起的亡灵	了不起的亡灵
狙击电话亭	狙击电话亭
微笑曙光	微笑曙光
命运呼叫转移	命运呼叫转移
像春天一样	像春天一样
空中监狱	空中监狱
爱情上上签	爱情上上签
首尔1945	首尔1945
无耻之徒	无耻之徒
华丽一族	华丽一族
蒲公英	蒲公英
爱的契约	爱的契约
金玉良缘	金玉良缘
危城之恋	危城之恋
十三妹	十三妹
我的秘密	我的秘密
Be with You	Be with You
长男的媳妇	长男的媳妇
是否我真的一无所有	是否我真的一无所有
上海纪事	上海纪事
倩女幽魂Ⅲ：道道道	倩女幽魂Ⅲ：道道道
哈拉上路	哈拉上路
关键第4号	关键第4号
蓝色大海的传说	蓝色大海的传说
温柔的慈悲	温柔的慈悲
味道	味道
替身杀手	替身杀手
我的武林男友	我的武林男友
铁血警魂	铁血警魂
为了遇见你	为了遇见你
水中望月	水中望月
一生只爱你	一生只爱你
血战长空	血战长空
牵牛花开的日子	牵牛花开的日子
假面骑士KABUTO	假面骑士KABUTO
陈赓大将	陈赓大将
Set Me Free	Set Me Free
大南迁	大南迁
Price Tag	Price Tag
天下第一味	天下第一味
我的好兄弟	我的好兄弟
有多少爱可以重来	有多少爱可以重来
水手服僵尸	水手服僵尸
囧探查过界	囧探查过界
so goodbye	so goodbye
心乱如麻	心乱如麻
白蛇新传	白蛇新传
心世界	心世界
星光下的童话	星光下的童话
钝悟	钝悟
我会一直在这里	我会一直在这里
让世界停止	让世界停止
追梦	追梦
仙剑奇侠传	仙剑奇侠传
我是业主	我是业主
神盾局特工	神盾局特工
苦恋花	苦恋花
消失的凶手	消失的凶手
happiness	happiness
46亿年之恋	46亿年之恋
毛骨悚然	毛骨悚然
明天	明天
谢谢你的爱	谢谢你的爱
halo	halo
社交网络	社交网络
妖精的尾巴	妖精的尾巴
ebb and flow	ebb and flow
你能听到我的心吗	你能听到我的心吗
如意	如意
被嫌弃的松子的一生	被嫌弃的松子的一生
under pressure	under pressure
湾仔之虎	湾仔之虎
广告狂人	广告狂人
无与伦比的美丽	无与伦比的美丽
最后的灰姑娘	最后的灰姑娘
天地争霸美猴王	天地争霸美猴王
请与废柴的我谈恋爱	请与废柴的我谈恋爱
走出你的世界我更寂寞	走出你的世界我更寂寞
揺れる想い	揺れる想い
武僧传奇	武僧传奇
悟空	悟空
特命系长只野仁	特命系长只野仁
俘虏兵	俘虏兵
咚巴拉	咚巴拉
无忧花开	无忧花开
活宝	活宝
亲爱的人	亲爱的人
玉蒲团Ⅲ官人我要	玉蒲团Ⅲ官人我要
寻找心中的你	寻找心中的你
一代宗师	一代宗师
末代皇后	末代皇后
Fuck you	Fuck you
真田志郎	真田志郎
一无所有时爱你的人	一无所有时爱你的人
师父·明白了	师父·明白了
原谅我一次	原谅我一次
胭脂	胭脂
大上海	大上海
城市游戏	城市游戏
今天的恋爱	今天的恋爱
梁霞仙	梁霞仙
雪狼湖	雪狼湖
兔子洞	兔子洞
庄子试妻	庄子试妻
诗人回忆录	诗人回忆录
You and I	You and I
赌圣	赌圣
男丁格尔	男丁格尔
不被原谅的搜查官	不被原谅的搜查官
尖峰时刻3	尖峰时刻3
表姐，你好嘢！	表姐，你好嘢！
听见幸福	听见幸福
男人心	男人心
裸婚	裸婚
焦裕禄	焦裕禄
餐馆	餐馆
情定温布尔登	情定温布尔登
极品新娘	极品新娘
一个人一座城	一个人一座城
怀玉传奇千金妈祖	怀玉传奇千金妈祖
再见了，最爱的人	再见了，最爱的人
朱蒙	朱蒙
再生侠	再生侠
开心就好	开心就好
离婚律师	离婚律师
许愿盒	许愿盒
人间喜剧	人间喜剧
神秘人质	神秘人质
福禄寿三星报喜	福禄寿三星报喜
神原秋人	神原秋人
海啸	海啸
在我耳边的candy	在我耳边的candy
特工艾米拉	特工艾米拉
恶魔在身边	恶魔在身边
天可怜见	天可怜见
胆小鬼	胆小鬼
铜鼓县	铜鼓县
新包青天	新包青天
荒川爆笑团	荒川爆笑团
辣椒教室	辣椒教室
卖苗郎	卖苗郎
赤桑镇	赤桑镇
华丽的休假	华丽的休假
大破铜网阵	大破铜网阵
战地尖刀	战地尖刀
金馆长对金馆长对金馆长	金馆长对金馆长对金馆长
罪有应得	罪有应得
顺风车	顺风车
kano	kano
泪王子	泪王子
球杆	球杆
料理高校生	料理高校生
等待绽放	等待绽放
出路	出路
中央电视台春节联欢晚会	中央电视台春节联欢晚会
怒海余生	怒海余生
滴答	滴答
超级猪	超级猪
黑猫	黑猫
承认	承认
姐妹姐妹	姐妹姐妹
花郎	花郎
土地公传奇	土地公传奇
越策越开心	越策越开心
西窗	西窗
奔跑	奔跑
火红的日子	火红的日子
反击	反击
纽约的冬天	纽约的冬天
一剪梅	一剪梅
香城浪子	香城浪子
想太多	想太多
爱的独白	爱的独白
则卷阿拉蕾	则卷阿拉蕾
月弯弯	月弯弯
妈妈打电话	妈妈打电话
敏行快跑	敏行快跑
张羽煮海	张羽煮海
别忘了为什么出发	别忘了为什么出发
坏姐姐	坏姐姐
摇滚七十年代	摇滚七十年代
露娜玛丽亚·霍克	露娜玛丽亚·霍克
木土日斤	木土日斤
大汉天子2	大汉天子2
大汉天子3	大汉天子3
乡下姑娘	乡下姑娘
北斗卫星导航系统	北斗卫星导航系统
Alive	Alive
桃色	桃色
流氓皇帝	流氓皇帝
我不是黄蓉	我不是黄蓉
游城十代	游城十代
青春是	青春是
祝酒歌	祝酒歌
苍穹之昴	苍穹之昴
折翼小天使	折翼小天使
我的乌鸦男友	我的乌鸦男友
欢喜楼	欢喜楼
让世界听到	让世界听到
浪漫满屋	浪漫满屋
高粱红了	高粱红了
大海航行靠舵手	大海航行靠舵手
幸福的女人	幸福的女人
爵迹	爵迹
亲爱的翻译官	亲爱的翻译官
超越巅峰	超越巅峰
战火四千金	战火四千金
狗咬狗	狗咬狗
情枭的黎明	情枭的黎明
我的蠢萌老公	我的蠢萌老公
特警飞龙	特警飞龙
躁动的青春	躁动的青春
不再沉默	不再沉默
三只小猪	三只小猪
证人	证人
小岛惊魂	小岛惊魂
缘分	缘分
好大一棵树	好大一棵树
最后一个大侠	最后一个大侠
蒲田进行曲	蒲田进行曲
造梦者	造梦者
大梦敦煌	大梦敦煌
当我知道你们相爱	当我知道你们相爱
校园迷糊大王	校园迷糊大王
冬天里的白玫瑰	冬天里的白玫瑰
湘女萧萧	湘女萧萧
十三角关系	十三角关系
神枪狙击	神枪狙击
狼烟遍地	狼烟遍地
芳芳	芳芳
救命病栋24小时	救命病栋24小时
铁血将军	铁血将军
风之刀武林启示录	风之刀武林启示录
显微镜下的爱情	显微镜下的爱情
其实很寂寞	其实很寂寞
丝路	丝路
名扬花鼓	名扬花鼓
惊天阴谋	惊天阴谋
逃避虽可耻但有用	逃避虽可耻但有用
